Pseudomonas aeruginosa BWHPSA039 adkgf-supercont1.1, whole genome shotgun sequence.	GCF0005204151	NZKI9145301	2639633	2643533	3900
Pseudomonas aeruginosa strain AUS483 IPC434_1.1, whole genome shotgun sequence	GCF0038390251	NZNSXA010000011	301747	322613	20866
Pseudomonas aeruginosa strain AZPAE14877 AZPAE14877_contig_7, whole genome shotgun sequence.	GCF0007904851	NZJTTL010000071	258256	304134	45878
Pseudomonas aeruginosa strain Pa2441 K9_S46_R1__paired__contig_8, whole genome shotgun sequence	GCF0036113951	NZNRCC010000081	113114	162227	49113
Pseudomonas aeruginosa strain IMP66 chromosome, complete genome	GCF0080337651	NZCP0289591	2461503	2477118	15615
Pseudomonas aeruginosa strain Y71 chromosome, complete genome	GCF0034084951	NZCP0309111	2453519	2510521	57002
Pseudomonas aeruginosa isolate 112, whole genome shotgun sequence.	GCF9001445351	NZFRII010000341	39288	69451	30163
Pseudomonas aeruginosa strain TNCF_49M NODE_18_length_142543_cov_12.8506_ID_35, whole genome shotgun sequence.	GCF0017657151	NZMAZO010000251	83317	130468	47151
Pseudomonas aeruginosa strain FDAARGOS_154 scf7180000000010_quiver_pilon, whole genome shotgun sequence.	GCF0014713551	NZLORM020000011	5776532	5919199	142667
Pseudomonas aeruginosa strain WH-SGI-V-07409 WH-SGI-V-07409_contig3, whole genome shotgun sequence.	GCF0014513351	NZLLOW010000681	481191	537091	55900
Pseudomonas aeruginosa strain 163940 TF3940_S24_R1_001__paired__contig_2, whole genome shotgun sequence	GCF0037213951	NZRJAG010000021	35173	54708	19535
Pseudomonas aeruginosa strain AZPAE14550 AZPAE14550_contig_3, whole genome shotgun sequence.	GCF0007944251	NZJTXW010000031	43317	71331	28014
Pseudomonas aeruginosa strain NCTC10731, whole genome shotgun sequence.	GCF9004553851	NZUGUI010000021	11994	55671	43677
Pseudomonas aeruginosa strain WH-SGI-V-07619 WH-SGI-V-07619_contig15, whole genome shotgun sequence.	GCF0014519651	NZLLQQ010000501	54502	109815	55313
Pseudomonas aeruginosa strain PASGNDM591 PASGNDM591_contig_8, whole genome shotgun sequence.	GCF0021349651	NZNDFW010000431	55930	116115	60185
Pseudomonas aeruginosa strain ATCC 9027 NODE_2_length_504645_cov_63.9523, whole genome shotgun sequence.	GCF0026018151	NZNIQD010000021	127593	183060	55467
Pseudomonas aeruginosa strain AZPAE14965 AZPAE14965_contig_10, whole genome shotgun sequence.	GCF0007919051	NZJTQC010000101	108102	135420	27318
Pseudomonas aeruginosa strain 4114358565 IPC1507_2.1, whole genome shotgun sequence	GCF0043710951	NZRWML010000021	7101	36265	29164
Pseudomonas aeruginosa strain WH-SGI-V-07071 WH-SGI-V-07071_contig1, whole genome shotgun sequence.	GCF0014492751	NZLLLH010000011	468659	479139	10480
Pseudomonas aeruginosa strain PA-W15 IPC9_2.1, whole genome shotgun sequence	GCF0038417151	NZNTAV010000021	387936	409398	21462
Pseudomonas aeruginosa strain PASGNDM587 PASGNDM587_contig_6, whole genome shotgun sequence.	GCF0021348951	NZNDFV010000421	55930	116115	60185
Pseudomonas aeruginosa strain Liverpool Epidemic Strain, whole genome shotgun sequence.	GCF0008244051	NZCCPG010000031	37886	123916	86030
Pseudomonas aeruginosa isolate 278, whole genome shotgun sequence.	GCF9001460851	NZFROG010000071	35792	100684	64892
Pseudomonas aeruginosa strain JYH15 IPC1226_1.1, whole genome shotgun sequence	GCF0039749951	NZRXBU010000011	478394	526486	48092
Pseudomonas aeruginosa strain WH-SGI-V-07693 WH-SGI-V-07693_contig16, whole genome shotgun sequence.	GCF0014525651	NZLLSN010000681	43979	110011	66032
Pseudomonas aeruginosa strain UMB2231 NODE_7_length_156382_cov_5.814598, whole genome shotgun sequence	GCF0098073951	NZWUDJ010000071	58651	106905	48254
Pseudomonas aeruginosa M9A.1 genomic scaffold adget-supercont1.1, whole genome shotgun sequence.	GCF0004805351	NZKI5187221	2021536	2035750	14214
Pseudomonas aeruginosa strain VET-21 NODE_5_length_264317_cov_27.147_ID_9, whole genome shotgun sequence	GCF0036306351	NZRACO010000681	80951	139988	59037
Pseudomonas aeruginosa genome assembly 251_10Pc_2_contgs_500, contig NODE_2_length_451136_cov_25.06_ID_3, whole genome shotgun sequence.	GCF0013739751	NZCTDP010000201	78411	98212	19801
Pseudomonas aeruginosa strain GO70 NODE_8_length_386768_cov_35.521321, whole genome shotgun sequence	GCF0070043651	NZVJMR010000081	304244	320571	16327
Pseudomonas aeruginosa BWHPSA017 genomic scaffold adgeW-supercont1.2, whole genome shotgun sequence.	GCF0004813651	NZKI5190641	1713226	1717126	3900
Pseudomonas aeruginosa isolate 209, whole genome shotgun sequence.	GCF9001455151	NZFRMB010000131	7790	23571	15781
Pseudomonas aeruginosa strain AUS222 IPC247_4.1, whole genome shotgun sequence	GCF0039766851	NZRXFG010000041	54027	75659	21632
Pseudomonas aeruginosa CF5 genomic scaffold adgfB-supercont1.1, whole genome shotgun sequence.	GCF0004818851	NZKI5192711	1675473	1698652	23179
Pseudomonas aeruginosa isolate 289, whole genome shotgun sequence.	GCF9001461951	NZFROR010000881	98593	163485	64892
Pseudomonas aeruginosa BL20 genomic scaffold adgeI-supercont1.1, whole genome shotgun sequence.	GCF0004807451	NZKI5187961	2480640	2489867	9227
Pseudomonas aeruginosa NCGM2.S1 DNA, complete genome.	GCF0002845551	NC0175491	4098397	4133468	35071
Pseudomonas aeruginosa strain AR_0456 AR_456.contig.0_1, whole genome shotgun sequence.	GCF0033242951	NZQMGO010000011	6419120	6485377	66257
Pseudomonas aeruginosa isolate LRJ15, whole genome shotgun sequence.	GCF9001482751	NZFRWN010000401	7801	24628	16827
Pseudomonas aeruginosa strain SCVJan, complete genome.	GCF0019002251	NZCP0134781	2408400	2430296	21896
Pseudomonas aeruginosa isolate 211, whole genome shotgun sequence.	GCF9001455351	NZFRMD010000061	7798	23579	15781
Pseudomonas aeruginosa LES400 sequence.	GCF0005839351	NZCP0069821	2503521	2550381	46860
Pseudomonas aeruginosa isolate paerg006, whole genome shotgun sequence	GCF9006079151	NZUWWR010000011	3737111	3771538	34427
Pseudomonas aeruginosa strain AMT0005-135 IPC540_2.1, whole genome shotgun sequence	GCF0039755351	NZRXDQ010000021	495337	509201	13864
Pseudomonas aeruginosa strain 6089 IPC1336_7.1, whole genome shotgun sequence	GCF0043714151	NZRWNZ010000071	56607	100215	43608
Pseudomonas aeruginosa strain PA-W22 IPC14_2.1, whole genome shotgun sequence	GCF0038416251	NZNTAQ010000021	317174	337071	19897
Pseudomonas aeruginosa strain PA-W36 IPC1295_1.1, whole genome shotgun sequence	GCF0038335451	NZNSNE010000011	145127	199066	53939
Pseudomonas aeruginosa strain 12-4-4(59), complete genome.	GCF0014823251	NZCP0136961	4014095	4077840	63745
Pseudomonas aeruginosa genome assembly 216_10Pc_7_contgs_500, contig NODE_2_length_451138_cov_25.5966_ID_3, whole genome shotgun sequence.	GCF0013745151	NZCTCR010000281	78413	98214	19801
Pseudomonas aeruginosa MH27, whole genome shotgun sequence.	GCF0005132351	NZCBTR0100000121	32059	61283	29224
Pseudomonas aeruginosa strain 293S080611BSL_PA1 IPC64_2.1, whole genome shotgun sequence	GCF0043746851	NZRWUC010000021	478615	492835	14220
Pseudomonas aeruginosa strain AZPAE14834 AZPAE14834_contig_11, whole genome shotgun sequence.	GCF0007942451	NZJTVA010000111	183995	236773	52778
Pseudomonas aeruginosa strain WH-SGI-V-07381 WH-SGI-V-07381_contig6, whole genome shotgun sequence.	GCF0014509251	NZLLOF010001001	170080	231240	61160
Pseudomonas aeruginosa strain PAC33B IPC147_4.1, whole genome shotgun sequence	GCF0043737951	NZRWSG010000041	555328	598936	43608
Pseudomonas aeruginosa strain FDAARGOS_610 chromosome, complete genome	GCF0063647951	NZCP0410131	4300404	4321704	21300
Pseudomonas aeruginosa strain Jp100 IPC750_1.1, whole genome shotgun sequence	GCF0039753851	NZRXDD010000011	614140	630967	16827
Pseudomonas aeruginosa genome assembly 259_Rw151_contgs_500, contig NODE_2_length_451136_cov_22.9688_ID_3, whole genome shotgun sequence.	GCF0013749751	NZCTDU010000721	78411	98212	19801
Pseudomonas aeruginosa BWHPSA005 genomic scaffold adgfj-supercont1.1, whole genome shotgun sequence.	GCF0004816051	NZKI5191531	2576313	2624408	48095
Pseudomonas aeruginosa strain F9676, complete genome.	GCF0010774751	NZCP0120661	3457313	3485764	28451
Pseudomonas aeruginosa strain AZPAE12423 AZPAE12423_contig_70, whole genome shotgun sequence.	GCF0007973551	NZJTZR010000701	5793	26070	20277
Pseudomonas aeruginosa strain AUS510 IPC447_2.1, whole genome shotgun sequence	GCF0039756451	NZRXEA010000021	339358	376539	37181
Pseudomonas aeruginosa strain 5990.1 IPC1311_3.1, whole genome shotgun sequence	GCF0043721351	NZRWOY010000031	297803	318357	20554
Pseudomonas aeruginosa C23 genomic scaffold adggj-supercont1.1, whole genome shotgun sequence.	GCF0004804951	NZKI5187161	2535470	2583562	48092
Pseudomonas aeruginosa strain 6086.2 IPC1333_1.1, whole genome shotgun sequence	GCF0043715051	NZRWOC010000011	394366	419375	25009
Pseudomonas aeruginosa BWHPSA006 genomic scaffold adhwj-supercont1.1, whole genome shotgun sequence.	GCF0004815851	NZKI5191451	2633026	2660449	27423
Pseudomonas aeruginosa strain Jp60 IPC748_1.1, whole genome shotgun sequence	GCF0039761851	NZRXDE010000011	684952	750229	65277
Pseudomonas aeruginosa MSH-10 genomic scaffold acUKG-supercont1.1, whole genome shotgun sequence.	GCF0004079051	NZKE1386721	1725272	1743640	18368
Pseudomonas aeruginosa strain 279 scaffold_0, whole genome shotgun sequence.	GCF0023123851	NZMWYH010000011	478018	526071	48053
Pseudomonas aeruginosa genome assembly 212_Rw184_contgs_500, contig NODE_2_length_451136_cov_25.2083_ID_3, whole genome shotgun sequence.	GCF0013735951	NZCUWZ010000441	78411	98212	19801
Pseudomonas aeruginosa genome assembly PAO1OR, chromosome : I.	GCF9000703751	NZLN8711871	2416008	2429696	13688
Pseudomonas aeruginosa PA7 chromosome, complete genome.	GCF0000172051	NC0096561	2519655	2541004	21349
Pseudomonas aeruginosa strain PA-W20 IPC13_1.1, whole genome shotgun sequence	GCF0038417051	NZNTAR010000011	515453	524680	9227
Pseudomonas aeruginosa strain Liverpool Epidemic Strain, whole genome shotgun sequence.	GCF0008246851	NZCCPA010000031	37886	123916	86030
Pseudomonas aeruginosa strain AZPAE12146 AZPAE12146_contig_9, whole genome shotgun sequence.	GCF0007967651	NZJUAQ010000091	250662	261141	10479
Pseudomonas aeruginosa strain WH-SGI-V-07488 WH_SGI_V_07488_17, whole genome shotgun sequence.	GCF0014516451	NZLLPU010000261	54775	68825	14050
Pseudomonas aeruginosa strain env068 NODE_4_length_548290_cov_12.435, whole genome shotgun sequence.	GCF0023308851	NZNRBE010000041	471602	498726	27124
Pseudomonas aeruginosa strain HUM-259 NODE_11_length_143585_cov_18.0451_ID_21, whole genome shotgun sequence	GCF0036318451	NZRAAA010000111	38221	93535	55314
Pseudomonas aeruginosa strain AZPAE14997 AZPAE14997_contig_4, whole genome shotgun sequence.	GCF0007926051	NZJTOX010000041	129720	162885	33165
Pseudomonas aeruginosa strain T2436 chromosome, complete genome	GCF0097204051	NZCP0399881	2434159	2464832	30673
Pseudomonas aeruginosa strain AUS134 IPC375_2.1, whole genome shotgun sequence	GCF0038392051	NZNSXK010000021	299852	328900	29048
Pseudomonas aeruginosa strain Liverpool Epidemic Strain, whole genome shotgun sequence.	GCF0008239651	NZCCOF010000031	37939	123969	86030
Pseudomonas aeruginosa strain 4064321111 IPC1494_1.1, whole genome shotgun sequence	GCF0043706151	NZRWMX010000011	348112	373760	25648
Pseudomonas aeruginosa strain AZPAE14964 AZPAE14964_contig_23, whole genome shotgun sequence.	GCF0007918351	NZJTQD010000231	249393	276711	27318
Pseudomonas aeruginosa strain AUS120 IPC365_1.1, whole genome shotgun sequence	GCF0038405551	NZNSXM010000011	606677	620727	14050
Pseudomonas aeruginosa isolate 192, whole genome shotgun sequence.	GCF9001453451	NZFRLN010000421	100602	133034	32432
Pseudomonas aeruginosa strain PABL061 NODE_15_length_167621_cov_78.8087, whole genome shotgun sequence	GCF0034113451	NZQVCI010000151	41882	105726	63844
Pseudomonas aeruginosa isolate 282, whole genome shotgun sequence.	GCF9001461251	NZFROK010000451	99101	163993	64892
Pseudomonas aeruginosa strain FRD1, complete genome.	GCF0008298851	NZCP0105551	1664557	1743789	79232
Pseudomonas aeruginosa strain PS00100 unitig_0, whole genome shotgun sequence	GCF0037038551	NZNTGD010000021	3379366	3406992	27626
Pseudomonas aeruginosa strain env103 NODE_1_length_632579_cov_10.6944, whole genome shotgun sequence.	GCF0023307651	NZNRAY010000011	289010	303270	14260
Pseudomonas aeruginosa strain 462 scaffold_1, whole genome shotgun sequence.	GCF0023120651	NZMWXK010000021	478470	526562	48092
Pseudomonas aeruginosa genome assembly 267_15_211Gb_contgs_500, contig NODE_2_length_451136_cov_28.5626_ID_3, whole genome shotgun sequence.	GCF0013751351	NZCTEW010000231	78411	98212	19801
Pseudomonas aeruginosa strain Pa127 chromosome, complete genome.	GCF0022053551	NZCP0220001	2644527	2690383	45856
Pseudomonas aeruginosa strain WH-SGI-V-07631 WH-SGI-V-07631_contig1, whole genome shotgun sequence.	GCF0014534051	NZLLRC010000011	271966	297614	25648
Pseudomonas aeruginosa strain 4124363474-14 IPC1501_1.1, whole genome shotgun sequence	GCF0043705151	NZRWMR010000011	478223	526315	48092
Pseudomonas aeruginosa strain 1689 1689_NODE_2_length_387887_cov_87.1549, whole genome shotgun sequence	GCF0038634451	NZRRBX010000021	39324	55105	15781
Pseudomonas aeruginosa strain VNMU149 MRSN567329_contig00002, whole genome shotgun sequence	GCF0098876451	NZWXZS010000021	505253	558031	52778
Pseudomonas aeruginosa strain UMB2261 NODE_3_length_185220_cov_5.813024, whole genome shotgun sequence	GCF0098072751	NZWUDH010000031	7706	61807	54101
Pseudomonas aeruginosa strain 829 829_NODE_1.ctg_1, whole genome shotgun sequence.	GCF0021938351	NZNIPE010000231	386617	432359	45742
Pseudomonas aeruginosa strain NCTC8203, whole genome shotgun sequence.	GCF9004554451	NZUAWU010000111	71066	100251	29185
Pseudomonas aeruginosa strain PAG scaffold1, whole genome shotgun sequence.	GCF0007434051	NZKN0506411	5953747	5957647	3900
Pseudomonas aeruginosa isolate 124, whole genome shotgun sequence.	GCF9001446651	NZFRIT010000121	103989	140650	36661
Pseudomonas aeruginosa strain TNCF_85 NODE_1_length_564602_cov_20.5663_ID_1, whole genome shotgun sequence.	GCF0017657951	NZMAZS010000251	83354	130505	47151
Pseudomonas aeruginosa strain A11 IPC690_2.1, whole genome shotgun sequence	GCF0038369451	NZNSUX010000021	282448	328966	46518
Pseudomonas aeruginosa LESlike1 sequence.	GCF0005839751	NZCP0069841	2503444	2550305	46861
Pseudomonas aeruginosa genome assembly 239_10Pc_1_contgs_500, contig NODE_1_length_451159_cov_22.6497_ID_1, whole genome shotgun sequence.	GCF0013737351	NZCTDH010000311	78434	98235	19801
Pseudomonas aeruginosa isolate 241, whole genome shotgun sequence.	GCF9001457651	NZFRNA010000721	7775	23390	15615
Pseudomonas aeruginosa strain 14649 contig_54, whole genome shotgun sequence.	GCF0014141051	NZLKPS010000121	1348434	2274234	925800
Pseudomonas aeruginosa strain 759 759_NODE_17.ctg_1, whole genome shotgun sequence.	GCF0021939951	NZNIPC010000821	24611	38475	13864
Pseudomonas aeruginosa strain PABL017 chromosome, complete genome	GCF0034292051	NZCP0316601	2434392	2461622	27230
Pseudomonas aeruginosa isolate 344, whole genome shotgun sequence.	GCF9001467251	NZFRQR010000211	7797	27598	19801
Pseudomonas aeruginosa strain S2239_15 IPC902_1.1, whole genome shotgun sequence	GCF0038362751	NZNSSK010000011	296038	345267	49229
Pseudomonas aeruginosa strain NCTC11448, whole genome shotgun sequence.	GCF9004551151	NZUGUE010000011	276649	303234	26585
Pseudomonas aeruginosa strain AZPAE14693 AZPAE14693_contig_26, whole genome shotgun sequence.	GCF0007946251	NZJTXL010000261	39295	57807	18512
Pseudomonas aeruginosa strain LiA63_2006 IPC790_3.1, whole genome shotgun sequence	GCF0038363851	NZNSTE010000031	212930	295028	82098
Pseudomonas aeruginosa strain ATCC BAA-2112 IPC1580_2.1, whole genome shotgun sequence.	GCF0022370851	NZMVGZ010000021	1523806	1558873	35067
Pseudomonas aeruginosa strain S04 90 genome.	GCF0009885051	NZCP0113691	2580027	2584535	4508
Pseudomonas aeruginosa genome assembly 209_15_321Gb_contgs_500, contig NODE_2_length_451136_cov_29.4982_ID_3, whole genome shotgun sequence.	GCF0013744151	NZCTCP010000301	78411	98212	19801
Pseudomonas aeruginosa strain Ocean-1206 scaffold19_cov1221_read216, whole genome shotgun sequence.	GCF0022636151	NZNMRP010000191	252121	285699	33578
Pseudomonas sp. HMSC067D05 Scaffold203, whole genome shotgun sequence.	GCF0018112151	NZKV8039381	477736	496899	19163
Pseudomonas aeruginosa strain AZPAE14971 AZPAE14971_contig_90, whole genome shotgun sequence.	GCF0007920051	NZJTPX010000901	32558	35076	2518
Pseudomonas aeruginosa strain SJU-S79_1 NODE_8_length_283846_cov_63.9904, whole genome shotgun sequence.	GCF0023297751	NZNRFA010000081	61498	70824	9326
Pseudomonas aeruginosa 62 genomic scaffold adgfr-supercont1.2, whole genome shotgun sequence.	GCF0004820251	NZKI5193161	1692276	1713232	20956
Pseudomonas aeruginosa BL17 genomic scaffold adggm-supercont1.1, whole genome shotgun sequence.	GCF0004808051	NZKI5188221	2583357	2612581	29224
Pseudomonas aeruginosa strain DUN-007-2 IPC1006_1.1, whole genome shotgun sequence	GCF0038357651	NZNSRC010000011	625792	679734	53942
Pseudomonas aeruginosa C-NN2 isolate early isolate NN2 (clone C) genome assembly, chromosome: I.	GCF9001852551	NZLT8831431	2597702	2645794	48092
Pseudomonas aeruginosa strain PABL003 NODE_14_length_111217_cov_101.048, whole genome shotgun sequence	GCF0034122951	NZQVEG010000141	43031	71482	28451
Pseudomonas aeruginosa strain F34365 contig1, whole genome shotgun sequence.	GCF0027240751	NZJPDZ010000011	2453242	2483135	29893
Pseudomonas aeruginosa BWHPSA021 genomic scaffold adgeQ-supercont1.1, whole genome shotgun sequence.	GCF0004812851	NZKI5190231	1681610	1712281	30671
Pseudomonas aeruginosa MTB-1, complete genome.	GCF0005040451	NC0230191	2397475	2435838	38363
Pseudomonas aeruginosa strain SCAID WND2-2019 chromosome	GCF0075669551	NZCP0417861	3007367	3022784	15417
Pseudomonas aeruginosa strain AZPAE14999 AZPAE14999_contig_7, whole genome shotgun sequence.	GCF0007926351	NZJTOV010000071	244384	273489	29105
Pseudomonas aeruginosa strain TNCF_12 NODE_14_length_142564_cov_14.1438_ID_27, whole genome shotgun sequence.	GCF0017655751	NZMAZG010000261	83331	130482	47151
Pseudomonas aeruginosa strain COPD6d Contig2, whole genome shotgun sequence.	GCF0020216352	NZMWLC020001151	7799	205048	197249
Pseudomonas aeruginosa strain AR_460 chromosome, complete genome.	GCF0032883351	NZCP0303511	746859	766921	20062
Pseudomonas aeruginosa BWHPSA019 genomic scaffold adgfe-supercont1.2, whole genome shotgun sequence.	GCF0004813251	NZKI5190521	645144	679331	34187
Pseudomonas aeruginosa strain WH-SGI-V-07273 WH_SGI_V_07273_3, whole genome shotgun sequence.	GCF0014539051	NZLLUB010000231	42155	96095	53940
Pseudomonas aeruginosa strain AZPAE14879 AZPAE14879_contig_11, whole genome shotgun sequence.	GCF0007905251	NZJTTJ010000111	122678	138460	15782
Pseudomonas aeruginosa strain PA57 contig000004, whole genome shotgun sequence.	GCF0033325251	NZQDGS010000041	40665	53639	12974
Pseudomonas aeruginosa strain AZPAE15032 AZPAE15032_contig_9, whole genome shotgun sequence.	GCF0007915651	NZJTNO010000091	79938	132706	52768
Pseudomonas aeruginosa strain AZPAE12416 AZPAE12416_contig_26, whole genome shotgun sequence.	GCF0007971851	NZJTZY010000261	117507	137784	20277
Pseudomonas aeruginosa strain KCJ3K95 NODE_2_length_225422_cov_6.474844, whole genome shotgun sequence	GCF0088025951	NZVZIT010000021	39286	104720	65434
Pseudomonas aeruginosa strain 4068 4068-unitig_9, whole genome shotgun sequence	GCF0097250151	NZWOFT010000011	3868789	3986648	117859
Pseudomonas aeruginosa isolate 155, whole genome shotgun sequence.	GCF9001449451	NZFRJU010002381	0	25262	25262
Pseudomonas aeruginosa strain PABL002 NODE_7_length_233600_cov_44.8072, whole genome shotgun sequence	GCF0034122851	NZQVEH010000071	162440	182241	19801
Pseudomonas aeruginosa strain U350 IPC946_3.1, whole genome shotgun sequence	GCF0038359851	NZNSRY010000031	477736	507619	29883
Pseudomonas aeruginosa genome assembly 287_10Pc_5_contgs_500, contig NODE_24_length_96203_cov_24.9012_ID_47, whole genome shotgun sequence.	GCF0013742151	NZCTFK010000601	35131	53198	18067
Pseudomonas aeruginosa strain J80UH1OS1 IPC744_7.1, whole genome shotgun sequence	GCF0038365051	NZNSTR010000071	146186	181882	35696
Pseudomonas aeruginosa strain AZPAE14944 AZPAE14944_contig_7, whole genome shotgun sequence.	GCF0007914251	NZJTQX010000071	39394	87486	48092
Pseudomonas sp. HMSC071F02 Scaffold364, whole genome shotgun sequence.	GCF0018376851	NZKV8335301	41127	66137	25010
Pseudomonas aeruginosa CF18 genomic scaffold adgfD-supercont1.1, whole genome shotgun sequence.	GCF0004819251	NZKI5192811	1605518	1653622	48104
Pseudomonas aeruginosa BWHPSA044 adkfY-supercont1.1, whole genome shotgun sequence.	GCF0005203151	NZKI9144811	2080960	2100761	19801
Pseudomonas aeruginosa strain ATCC 27853, complete genome.	GCF0016189251	NZCP0151171	5955635	5959535	3900
Pseudomonas aeruginosa isolate 124.1, whole genome shotgun sequence.	GCF9001476951	NZFRUL010000631	103508	140169	36661
Pseudomonas aeruginosa strain NCTC12448, whole genome shotgun sequence.	GCF9004553951	NZUATX010000011	914827	934628	19801
Pseudomonas aeruginosa strain T6313 contig1, whole genome shotgun sequence.	GCF0029271551	NZJPFD010000011	2758051	2761951	3900
Pseudomonas aeruginosa strain PSE305.	GCF0007509051	NZHG9742341	3030990	3154723	123733
Pseudomonas aeruginosa MRW44.1 contig00002, whole genome shotgun sequence.	GCF0002829151	NZALBW010000021	588041	601729	13688
Pseudomonas aeruginosa strain Pa58 chromosome, complete genome.	GCF0021924951	NZCP0217751	2728898	2737317	8419
Pseudomonas aeruginosa strain 11 IPC1593_2.1, whole genome shotgun sequence	GCF0043709251	NZRWLK010000021	613230	636164	22934
Pseudomonas aeruginosa strain AZPAE14441 AZPAE14441_contig_29, whole genome shotgun sequence.	GCF0007962851	NZJTYI010000291	56498	174881	118383
Pseudomonas aeruginosa strain AMT0026-1 IPC553_2.1, whole genome shotgun sequence	GCF0039762651	NZRXDK010000021	347349	372997	25648
Pseudomonas aeruginosa strain U0272B IPC922_3.1, whole genome shotgun sequence	GCF0038362051	NZNSSE010000031	477736	507619	29883
Pseudomonas aeruginosa genome assembly 217_12_5Pc_4_contgs_500, contig NODE_1_length_451159_cov_28.8019_ID_5, whole genome shotgun sequence.	GCF0013745351	NZCTCS010000171	78434	98235	19801
Pseudomonas aeruginosa strain MCF104 IPC1367_1.1, whole genome shotgun sequence	GCF0039746851	NZRXBF010000011	466979	477300	10321
Pseudomonas aeruginosa isolate 287, whole genome shotgun sequence.	GCF9001461851	NZFROO010000361	7785	66830	59045
Pseudomonas aeruginosa strain BTP034 MC15175091, whole genome shotgun sequence.	GCF0010867551	NZLFMR010000011	1238049	1325519	87470
Pseudomonas aeruginosa strain JYH7 IPC1218_1.1, whole genome shotgun sequence	GCF0039750551	NZRXBY010000011	356105	559196	203091
Pseudomonas aeruginosa strain S443_C09_RS S443_C09_RS_NODE_6_length_323640, whole genome shotgun sequence.	GCF0021360151	NZNFGD010000061	173507	187372	13865
Pseudomonas aeruginosa strain PAC15B IPC140_1.1, whole genome shotgun sequence	GCF0043735151	NZRWSN010000011	189438	212571	23133
Pseudomonas aeruginosa strain GIMC5016:PA1840, complete sequence	GCF0040004951	NZCP0344301	2565447	2583230	17783
Pseudomonas aeruginosa strain PA55 contig000012, whole genome shotgun sequence.	GCF0033324251	NZQDGH010000121	35123	54658	19535
Pseudomonas aeruginosa strain AU13213 NODE_2_length_708584_cov_6.03637_ID_3, whole genome shotgun sequence.	GCF0015546151	NZLRYS010000221	488237	542175	53938
Pseudomonas aeruginosa strain AR_0110 chromosome, complete genome.	GCF0032043351	NZCP0297451	2508100	2557547	49447
Pseudomonas aeruginosa strain AZPAE15031 AZPAE15031_contig_24, whole genome shotgun sequence.	GCF0007918551	NZJTNP010000241	118038	182922	64884
Pseudomonas aeruginosa strain SCH_ABX17 ABX17_contig000001, whole genome shotgun sequence.	GCF0019903751	NZMULA010000011	298732	325535	26803
Pseudomonas aeruginosa strain AR_0230 chromosome, complete genome.	GCF0029686951	NZCP0271741	1089522	1138969	49447
Pseudomonas aeruginosa strain CCBH18249 scaffold19.1, whole genome shotgun sequence	GCF0041463251	NZSELB010000191	72759	125512	52753
Pseudomonas aeruginosa SG17M Scaffold1, whole genome shotgun sequence.	GCF0005682151	NZJALF010000011	2929143	2982995	53852
Pseudomonas aeruginosa strain AZPAE14975 AZPAE14975_contig_48, whole genome shotgun sequence.	GCF0007920951	NZJTPT010000481	39333	57267	17934
Pseudomonas aeruginosa strain U397A IPC954_1.1, whole genome shotgun sequence	GCF0038371451	NZNSRW010000011	889201	919084	29883
Pseudomonas aeruginosa strain HUM-322-D1 PA3_H10_NODE_3_length_172056_cov_40.2865_ID_5, whole genome shotgun sequence	GCF0036323151	NZQZYO010000841	121920	141722	19802
Pseudomonas aeruginosa RB, whole genome shotgun sequence	GCF0006479352	NZDF3968061	479948	493493	13545
Pseudomonas aeruginosa RB, whole genome shotgun sequence	GCF0006479352	NZDF3968251	89558	99386	9828
Pseudomonas aeruginosa strain WH-SGI-V-07704 WH-SGI-V-07704_contig3, whole genome shotgun sequence.	GCF0014526851	NZLLSY010000231	356573	403724	47151
Pseudomonas aeruginosa strain 60503 chromosome, complete genome	GCF0075590651	NZCP0417741	2431801	2487114	55313
Pseudomonas aeruginosa strain Pa1207 chromosome, complete genome.	GCF0022086451	NZCP0220011	4965352	5066815	101463
Pseudomonas aeruginosa PA14 genomic scaffold acUKH-supercont1.1, whole genome shotgun sequence.	GCF0004042651	NZKE1363351	3069930	3095578	25648
Pseudomonas aeruginosa BWHPSA026 genomic scaffold adgfP-supercont1.1, whole genome shotgun sequence.	GCF0004811851	NZKI5189811	1713527	1789366	75839
Pseudomonas aeruginosa strain VD171 scaffold_1, whole genome shotgun sequence.	GCF0023127951	NZMWYO010000021	409423	449032	39609
Pseudomonas aeruginosa strain Liverpool Epidemic Strain, whole genome shotgun sequence.	GCF0008246451	NZCCOG010000031	34594	122073	87479
Pseudomonas aeruginosa genome assembly 288_12_5Pc_2_2_contgs_500, contig NODE_1_length_433141_cov_23.9265_ID_1, whole genome shotgun sequence.	GCF0013742351	NZCTFN010000751	373825	386028	12203
Pseudomonas aeruginosa VRFPA04, complete genome.	GCF0004737452	NZCP0087391	4273261	4279673	6412
Pseudomonas aeruginosa isolate 164, whole genome shotgun sequence.	GCF9001450651	NZFRKA010000721	101805	127453	25648
Pseudomonas aeruginosa CF_PA39 scaffold8, whole genome shotgun sequence.	GCF0005682352	NZJDVE010000081	18199	65154	46955
Pseudomonas aeruginosa strain 18G IPC574_3.1, whole genome shotgun sequence	GCF0043735951	NZRWQV010000031	185939	216726	30787
Pseudomonas aeruginosa strain HIAE_PA05 5c, whole genome shotgun sequence.	GCF0030555851	NZQBER010000051	251687	296360	44673
Pseudomonas aeruginosa isolate 1 genome assembly, chromosome: 1	GCF9004970251	NZLS9987831	2698882	2775850	76968
Pseudomonas aeruginosa strain 2S030611BSL_PA1 IPC26_3.1, whole genome shotgun sequence	GCF0043755151	NZRWVI010000031	122748	145558	22810
Pseudomonas aeruginosa isolate 292, whole genome shotgun sequence.	GCF9001462151	NZFROT010000061	176525	241417	64892
Pseudomonas aeruginosa strain T63266, complete genome.	GCF0015161051	NZCP0088681	4038660	4054276	15616
Pseudomonas aeruginosa strain FDAARGOS_570 chromosome, complete genome	GCF0038130251	NZCP0338351	4507113	4553474	46361
Pseudomonas aeruginosa LESB65 sequence.	GCF0005839551	NZCP0069831	2502891	2549751	46860
Pseudomonas aeruginosa strain NCTC12447, whole genome shotgun sequence.	GCF9004551751	NZUATS010000071	97262	155860	58598
Pseudomonas aeruginosa strain KCRI-309A isolate RDK02_309A, whole genome shotgun sequence.	GCF9004068851	NZOVCS010000041	39367	95267	55900
Pseudomonas aeruginosa strain 19SV IPC578_3.1, whole genome shotgun sequence	GCF0043726451	NZRWQS010000031	199117	229991	30874
Pseudomonas aeruginosa strain AMT0046-107 IPC561_2.1, whole genome shotgun sequence	GCF0039762351	NZRXDI010000021	475825	500520	24695
Pseudomonas aeruginosa strain AZPAE14928 AZPAE14928_contig_16, whole genome shotgun sequence.	GCF0007913251	NZJTRN010000161	113077	150255	37178
Pseudomonas aeruginosa isolate 157, whole genome shotgun sequence.	GCF9001449951	NZFRJO010000381	7785	27586	19801
Pseudomonas aeruginosa strain 259S240811BSL_PA1 IPC54_1.1, whole genome shotgun sequence	GCF0043745151	NZRWUK010000011	683777	731869	48092
Pseudomonas aeruginosa strain R486 GCID_CRPK_0019_NODE_8.ctg_1, whole genome shotgun sequence	GCF0039547251	NZRWWU010000581	24602	77380	52778
Pseudomonas aeruginosa strain UMB2738 NODE_5_length_256948_cov_6.230519, whole genome shotgun sequence	GCF0080861451	NZVSIZ010000051	197520	206747	9227
Pseudomonas aeruginosa strain AU16960 NODE_1_length_1254077_cov_7.53405_ID_1, whole genome shotgun sequence.	GCF0015546251	NZLRYT010000111	516320	570256	53936
Pseudomonas aeruginosa strain VET-22 NODE_7_length_207273_cov_21.0105_ID_13, whole genome shotgun sequence	GCF0036296951	NZRAEJ010000651	118086	167541	49455
Pseudomonas aeruginosa strain AUS136 IPC377_2.1, whole genome shotgun sequence	GCF0039768551	NZRXES010000021	473876	500688	26812
Pseudomonas aeruginosa strain SCH_ABX18 ABX18_contig000001, whole genome shotgun sequence.	GCF0019903351	NZMUKZ010000011	298733	325535	26802
Pseudomonas aeruginosa CF77 genomic scaffold adgeU-supercont1.1, whole genome shotgun sequence.	GCF0004803751	NZKI5186631	1545126	1549026	3900
Pseudomonas aeruginosa strain S1h NODE_1_length_486297_cov_23.7621, whole genome shotgun sequence.	GCF0023262651	NZNQZP010000011	257760	267094	9334
Pseudomonas aeruginosa 3580 adTxz-supercont1.1, whole genome shotgun sequence.	GCF0006291851	NZKK2124761	475821	503139	27318
Pseudomonas aeruginosa strain BTP032 MC15175067, whole genome shotgun sequence.	GCF0010866351	NZLFMP010000311	44318	79389	35071
Pseudomonas aeruginosa strain AR_0447 AR_447.contig.1_1, whole genome shotgun sequence.	GCF0032604151	NZQHCK010000021	6442180	6446080	3900
Pseudomonas aeruginosa strain WH-SGI-V-07680 WH-SGI-V-07680_contig12, whole genome shotgun sequence.	GCF0014524051	NZLLSA010000041	45296	106456	61160
Pseudomonas aeruginosa strain PA-VAP-3 chromosome	GCF0043469851	NZCP0283301	720185	4549914	3829729
Pseudomonas aeruginosa PA96.	GCF0006266552	NZCP0072241	2365541	2384053	18512
Pseudomonas aeruginosa strain WH-SGI-V-07492 WH-SGI-V-07492_contig2, whole genome shotgun sequence.	GCF0014531851	NZLLPY010000301	44034	98463	54429
Pseudomonas aeruginosa genome assembly 230_15Pc_4_contgs_500, contig NODE_2_length_451159_cov_25.9839_ID_3, whole genome shotgun sequence.	GCF0013747951	NZCUXH010000761	78434	98235	19801
Pseudomonas aeruginosa isolate 138.1, whole genome shotgun sequence.	GCF9001477451	NZFRUP010000471	51088	65846	14758
Pseudomonas aeruginosa strain Pa1780 K4_S91_R1__paired__contig_22, whole genome shotgun sequence	GCF0036700151	NZNRBQ010000221	17323	66770	49447
Pseudomonas aeruginosa strain HUM-302 PA3_H8_NODE_3_length_229999_cov_33.1407_ID_5, whole genome shotgun sequence	GCF0036288051	NZRAGB010000531	30569	167572	137003
Pseudomonas aeruginosa strain PA-W30 IPC18_1.1, whole genome shotgun sequence	GCF0038410951	NZNTAM010000011	478054	526146	48092
Pseudomonas aeruginosa strain NCTC13719, whole genome shotgun sequence.	GCF9004554151	NZUGUM010000041	2256607	2271565	14958
Pseudomonas aeruginosa strain AZPAE14872 AZPAE14872_contig_24, whole genome shotgun sequence.	GCF0007903551	NZJTTQ010000241	113122	171804	58682
Pseudomonas aeruginosa strain AU11991 NODE_2_length_579828_cov_6.67265_ID_3, whole genome shotgun sequence.	GCF0015548951	NZLRZM010000221	359692	419360	59668
Pseudomonas aeruginosa strain IMP68 chromosome, complete genome	GCF0080337451	NZCP0288491	2446588	2462203	15615
Pseudomonas aeruginosa strain 1336_PAER 817_107306_1598017_455_,...,385_, whole genome shotgun sequence.	GCF0010762251	NZJVTD010000741	75364	92330	16966
Pseudomonas aeruginosa strain AUS125 IPC369_2.1, whole genome shotgun sequence	GCF0039768751	NZRXEU010000021	481813	493425	11612
Pseudomonas aeruginosa strain MRSN390231 MRSN390231_contig00002, whole genome shotgun sequence	GCF0039689351	NZRXTZ010000021	884852	900633	15781
Pseudomonas aeruginosa strain 4012(0) isolate C3719 IPC1256_4.1, whole genome shotgun sequence	GCF0036987851	NZMCMM010000041	42282	66372	24090
Pseudomonas aeruginosa genome assembly 207_15_111C_contgs_500, contig NODE_17_length_149523_cov_29.5569_ID_33, whole genome shotgun sequence.	GCF0013754551	NZCTCN010000241	78411	98212	19801
Pseudomonas aeruginosa strain PA-CL513 IPC607_3.1, whole genome shotgun sequence	GCF0043728151	NZRWQA010000031	347731	373379	25648
Pseudomonas aeruginosa strain PA_D25, complete genome.	GCF0017218451	NZCP0125841	2519481	2545808	26327
Pseudomonas aeruginosa BL02 genomic scaffold adggf-supercont1.3, whole genome shotgun sequence.	GCF0004811051	NZKI5189511	871399	919491	48092
Pseudomonas aeruginosa strain SP4528 chromosome, complete genome	GCF0037167651	NZCP0334391	3958351	4021297	62946
Pseudomonas aeruginosa strain AUS177 IPC414_4.1, whole genome shotgun sequence	GCF0039757551	NZRXEG010000041	300689	315564	14875
Pseudomonas aeruginosa strain TNCF_16 NODE_4_length_422964_cov_27.8809_ID_7, whole genome shotgun sequence.	GCF0017661951	NZMAKL010000151	247043	294194	47151
Pseudomonas aeruginosa strain VET-65 PA2_C7_NODE_9_length_65713_cov_29.7147_ID_17, whole genome shotgun sequence	GCF0036296251	NZRAEN010002141	11224	54785	43561
Pseudomonas aeruginosa strain TNCF_167_1 NODE_9_length_223489_cov_8.01451_ID_17, whole genome shotgun sequence.	GCF0017660451	NZMBMO010000281	52586	99737	47151
Pseudomonas aeruginosa strain AZPAE14833 AZPAE14833_contig_8, whole genome shotgun sequence.	GCF0007942651	NZJTVB010000081	183994	236794	52800
Pseudomonas aeruginosa strain PAC18B IPC145_2.1, whole genome shotgun sequence	GCF0043734551	NZRWSI010000021	599507	643115	43608
Pseudomonas aeruginosa strain BTP037 MC15175136, whole genome shotgun sequence.	GCF0010866451	NZLFMU010000101	2497306	2532377	35071
Pseudomonas aeruginosa strain Liverpool Epidemic Strain, whole genome shotgun sequence.	GCF0008242051	NZCCOR010000031	35480	112646	77166
Pseudomonas aeruginosa genome assembly 270_Rw109_contgs_500, contig NODE_19_length_149546_cov_25.3866_ID_37, whole genome shotgun sequence.	GCF0013751951	NZCUXS010000201	78434	98235	19801
Pseudomonas aeruginosa strain WH-SGI-V-07299 WH_SGI_V_07299_3, whole genome shotgun sequence.	GCF0014538051	NZLLTG010000231	35234	54769	19535
Pseudomonas aeruginosa strain env065b NODE_1_length_823915_cov_8.12411, whole genome shotgun sequence.	GCF0023303951	NZNRBF010000011	312280	344712	32432
Pseudomonas aeruginosa strain HUM-329 PA3_E11_NODE_7_length_203314_cov_31.7551_ID_13, whole genome shotgun sequence	GCF0036299351	NZRADY010000621	114334	135966	21632
Pseudomonas aeruginosa isolate 132, whole genome shotgun sequence.	GCF9001447451	NZFRJC010000101	103529	140190	36661
Pseudomonas aeruginosa strain VET-122 NODE_7_length_280772_cov_34.381_ID_13, whole genome shotgun sequence	GCF0036315051	NZRAAX010001401	179937	201566	21629
Pseudomonas aeruginosa CF27 genomic scaffold adgfH-supercont1.1, whole genome shotgun sequence.	GCF0004819051	NZKI5192761	723504	743215	19711
Pseudomonas aeruginosa strain S827_C17_BS S827_C17_BS_NODE_5_length_264320, whole genome shotgun sequence.	GCF0021363651	NZNFFF010000051	198898	211709	12811
Pseudomonas aeruginosa genome assembly 222_Rw18_contgs_500, contig NODE_2_length_451160_cov_20.3094_ID_3, whole genome shotgun sequence.	GCF0013746351	NZCTCU010000771	78435	98236	19801
Pseudomonas aeruginosa strain AZPAE15020 AZPAE15020_contig_44, whole genome shotgun sequence.	GCF0007930551	NZJTOA010000441	42129	101174	59045
Pseudomonas aeruginosa strain NCTC11447, whole genome shotgun sequence.	GCF9004554051	NZUGUJ010000051	3667099	3678846	11747
Pseudomonas aeruginosa JJ692 genomic scaffold adgfu-supercont1.1, whole genome shotgun sequence.	GCF0004818051	NZKI5192511	2434058	2463282	29224
Pseudomonas aeruginosa strain Pa347 K57_S100_R1__paired__contig_49, whole genome shotgun sequence	GCF0036698551	NZNRCA010000491	48534	68157	19623
Pseudomonas aeruginosa isolate 198, whole genome shotgun sequence.	GCF9001454251	NZFRLR010000271	224658	246286	21628
Pseudomonas aeruginosa PACS2 chromosome, whole genome shotgun sequence, complete genome.	GCF0001683351	NZAAQW010000011	3742457	3796408	53951
Pseudomonas aeruginosa strain E90 chromosome, complete genome	GCF0087052351	NZCP0440061	2538415	2552631	14216
Pseudomonas aeruginosa isolate 83, whole genome shotgun sequence.	GCF9001442751	NZFRHF010001121	7799	24626	16827
Pseudomonas aeruginosa strain PA-CL516 IPC610_1.1, whole genome shotgun sequence	GCF0043727751	NZRWPX010000011	203242	256249	53007
Pseudomonas aeruginosa PA21_ST175 contig00007, whole genome shotgun sequence.	GCF0003421451	NZAOIH010000071	133758	147621	13863
Pseudomonas aeruginosa strain SCAID WND1-2019 chromosome	GCF0075672851	NZCP0417871	404575	407748	3173
Pseudomonas aeruginosa strain PA-CL514 IPC608_1.1, whole genome shotgun sequence	GCF0043723751	NZRWPZ010000011	203642	256649	53007
Pseudomonas aeruginosa strain PAC10A IPC124_1.1, whole genome shotgun sequence	GCF0043739651	NZRWTB010000011	683688	731780	48092
Pseudomonas aeruginosa 19660 genomic scaffold adgew-supercont1.1, whole genome shotgun sequence.	GCF0004817651	NZKI5192291	1736445	1767270	30825
Pseudomonas aeruginosa strain Pa84 chromosome, complete genome.	GCF0022053351	NZCP0219991	2507297	2517777	10480
Pseudomonas aeruginosa strain DUN-009B IPC1014_1.1, whole genome shotgun sequence	GCF0038357751	NZNSRA010000011	416550	449715	33165
Pseudomonas aeruginosa strain P2733 IPC1108_2.1, whole genome shotgun sequence	GCF0039760351	NZRXCN010000021	320154	343959	23805
Pseudomonas aeruginosa strain 172BR IPC1244_8.1, whole genome shotgun sequence	GCF0038342251	NZNSNY010000081	166156	224756	58600
Pseudomonas sp. HMSC065H02 Scaffold672, whole genome shotgun sequence.	GCF0018133251	NZKV8122941	41810	95749	53939
Pseudomonas aeruginosa strain Mi159 IPC856_2.1, whole genome shotgun sequence	GCF0038363151	NZNSSZ010000021	124094	145556	21462
Pseudomonas aeruginosa strain S1f NODE_7_length_199578_cov_10.2937, whole genome shotgun sequence.	GCF0023300651	NZNRFP010000071	54033	63367	9334
Pseudomonas aeruginosa strain PASGNDM571 PASGNDM571_contig_47, whole genome shotgun sequence.	GCF0021348451	NZNDFR010000251	55930	116115	60185
Pseudomonas aeruginosa strain HUM-335 NODE_17_length_117193_cov_18.3591_ID_33, whole genome shotgun sequence	GCF0036316251	NZRAAQ010000931	4633	65794	61161
Pseudomonas aeruginosa strain AG1 chromosome, complete genome	GCF0096623151	NZCP0457391	2763625	2835773	72148
Pseudomonas aeruginosa isolate 167, whole genome shotgun sequence.	GCF9001450851	NZFRKF010001661	48308	73956	25648
Pseudomonas aeruginosa strain 1311 1311_NODE_4_length_319871_cov_106.596, whole genome shotgun sequence	GCF0038638651	NZRRBC010000041	39342	89149	49807
Pseudomonas aeruginosa strain AZPAE14825 AZPAE14825_contig_22, whole genome shotgun sequence.	GCF0007953251	NZJTVJ010000221	133315	162127	28812
Pseudomonas aeruginosa strain PMM38 IPC888_15.1, whole genome shotgun sequence	GCF0038361351	NZNSSL010000151	45513	106673	61160
Pseudomonas aeruginosa strain AUS214 IPC236_3.1, whole genome shotgun sequence	GCF0039769651	NZRXFJ010000031	303318	319647	16329
Pseudomonas aeruginosa strain AZPAE14853 AZPAE14853_contig_12, whole genome shotgun sequence.	GCF0007899051	NZJTUI010000121	4624	63218	58594
Pseudomonas aeruginosa strain env050 NODE_3_length_580493_cov_13.741, whole genome shotgun sequence.	GCF0023308351	NZNRBI010000031	249078	276396	27318
Pseudomonas aeruginosa BWHPSA013 genomic scaffold adggn-supercont1.1, whole genome shotgun sequence.	GCF0004814451	NZKI5190781	2610173	2653781	43608
Pseudomonas aeruginosa strain AZPAE14848 AZPAE14848_contig_2, whole genome shotgun sequence.	GCF0007898051	NZJTUM010000021	122607	167575	44968
Pseudomonas aeruginosa strain PABL052 NODE_8_length_184913_cov_84.723, whole genome shotgun sequence	GCF0034117051	NZQVCR010000081	41929	145389	103460
Pseudomonas aeruginosa strain Ps04 PS04TE_1__paired__contig_2, whole genome shotgun sequence.	GCF0029152351	NZPQBU010000021	477453	493234	15781
Pseudomonas aeruginosa strain AUS392 IPC426_1.1, whole genome shotgun sequence	GCF0038390351	NZNSXC010000011	525365	553468	28103
Pseudomonas aeruginosa strain 020MIC IPC1033_1.1, whole genome shotgun sequence	GCF0038350951	NZNSQU010000011	396486	461386	64900
Pseudomonas aeruginosa strain 403 scaffold_0, whole genome shotgun sequence.	GCF0023126951	NZMWYM010000011	1253428	1269754	16326
Pseudomonas aeruginosa strain TNCF_174 NODE_22_length_122050_cov_14.2425_ID_43, whole genome shotgun sequence.	GCF0017660351	NZMBMP010000241	62804	109956	47152
Pseudomonas aeruginosa strain AUS232 IPC258_1.1, whole genome shotgun sequence	GCF0038397551	NZNSZA010000011	536550	606731	70181
Pseudomonas aeruginosa strain PABL102 NODE_12_length_135546_cov_69.29, whole genome shotgun sequence	GCF0034105851	NZQVAV010000121	39279	87383	48104
Pseudomonas aeruginosa strain HUM-273 PA3_A6_NODE_2_length_474523_cov_38.901_ID_3, whole genome shotgun sequence	GCF0036315751	NZRAAU010000791	335404	396583	61179
Pseudomonas aeruginosa strain PA-CL512 IPC606_1.1, whole genome shotgun sequence	GCF0043723951	NZRWQB010000011	344247	1730467	1386220
Pseudomonas aeruginosa strain U1849 GCID_CRPK_0014_NODE_7.ctg_1, whole genome shotgun sequence	GCF0039545251	NZRWWP010001001	90708	143068	52360
Pseudomonas aeruginosa strain NCTC12449, whole genome shotgun sequence.	GCF9004553251	NZUATV010000051	84535	107058	22523
Pseudomonas aeruginosa strain AZPAE15021 AZPAE15021_contig_20, whole genome shotgun sequence.	GCF0007930851	NZJTNZ010000201	184966	237771	52805
Pseudomonas aeruginosa strain Y89 chromosome, complete genome.	GCF0033697351	NZCP0309131	2454171	2511174	57003
Pseudomonas aeruginosa strain HUM-305 PA3_C9_NODE_1_length_448887_cov_32.058_ID_1, whole genome shotgun sequence	GCF0036295151	NZRAET010000011	380947	437950	57003
Pseudomonas aeruginosa PAO1 isolate 2017-I CEC25_11, whole genome shotgun sequence	GCF0039571951	NZQZGE010000111	157780	171468	13688
Pseudomonas aeruginosa genome assembly 211_Rw131_contgs_500, contig NODE_2_length_451136_cov_28.6233_ID_3, whole genome shotgun sequence.	GCF0013744551	NZCUWX010000371	78411	98212	19801
Pseudomonas aeruginosa strain WH-SGI-V-07372 WH-SGI-V-07372_contig9, whole genome shotgun sequence.	GCF0014501851	NZLLNW010000721	240658	263262	22604
Pseudomonas aeruginosa strain HUM-267 PA3_D5_NODE_4_length_210931_cov_26.3014_ID_7, whole genome shotgun sequence	GCF0036302751	NZRADH010001451	43272	86654	43382
Pseudomonas aeruginosa strain S442_C09_BS S442_C09_BS_NODE_6_length_306771, whole genome shotgun sequence.	GCF0021360551	NZNFGE010000061	173507	187372	13865
Pseudomonas aeruginosa strain HUM-263 PA3_H4_NODE_10_length_156796_cov_52.2544_ID_19, whole genome shotgun sequence	GCF0036315551	NZRAAV010001201	43779	104958	61179
Pseudomonas aeruginosa strain PAC42A IPC164_2.1, whole genome shotgun sequence	GCF0043737451	NZRWRQ010000021	421865	456371	34506
Pseudomonas aeruginosa strain 128S180412BSL_PA2 IPC33_6.1, whole genome shotgun sequence	GCF0043753751	NZRWVC010000061	42157	96101	53944
Pseudomonas aeruginosa LES431, complete genome.	GCF0005087651	NC0230661	2461617	2508476	46859
Pseudomonas aeruginosa strain PA151 contig_47_34_93, whole genome shotgun sequence.	GCF0028357651	NZPHSS010000191	4610	63210	58600
Pseudomonas aeruginosa strain AMT0005-137 IPC542_2.1, whole genome shotgun sequence	GCF0039762951	NZRXDO010000021	495337	509201	13864
Pseudomonas aeruginosa BWHPSA028 genomic scaffold adgfi-supercont1.1, whole genome shotgun sequence.	GCF0004811451	NZKI5189591	1692809	1780174	87365
Pseudomonas aeruginosa BWH055 adTzt-supercont1.1, whole genome shotgun sequence.	GCF0006294851	NZKK2132191	1588655	1639925	51270
Pseudomonas aeruginosa genome assembly 248_Rw198_contgs_500, contig NODE_1_length_751673_cov_19.9746_ID_1, whole genome shotgun sequence.	GCF0013739151	NZCTDN010000371	403333	414318	10985
Pseudomonas aeruginosa genome assembly 248_Rw198_contgs_500, contig NODE_2_length_451136_cov_19.4687_ID_3, whole genome shotgun sequence.	GCF0013739151	NZCTDN010000331	78411	98212	19801
Pseudomonas aeruginosa strain 549782 contig_70, whole genome shotgun sequence.	GCF0019096551	NZMPUX010000701	75341	137088	61747
Pseudomonas aeruginosa strain TNCF_32 NODE_1_length_601640_cov_25.798_ID_1, whole genome shotgun sequence.	GCF0017661451	NZMAKM010000211	120392	167543	47151
Pseudomonas aeruginosa strain CN573=PSE143 IPC705_1.1, whole genome shotgun sequence	GCF0038369051	NZNSUM010000011	44017	65646	21629
Pseudomonas aeruginosa strain AR_0095 chromosome, complete genome.	GCF0029970051	NZCP0275381	319257	355731	36474
Pseudomonas aeruginosa isolate 82, whole genome shotgun sequence.	GCF9001442351	NZFRHD010000021	474521	491348	16827
Pseudomonas aeruginosa strain PA181 NODE_2_length_649590_cov_18.538802, whole genome shotgun sequence	GCF0097274251	NZWOAQ010000021	366580	589661	223081
Pseudomonas aeruginosa strain AZPAE14809 AZPAE14809_contig_7, whole genome shotgun sequence.	GCF0007949951	NZJTVZ010000071	121786	151742	29956
Pseudomonas aeruginosa isolate 127, whole genome shotgun sequence.	GCF9001446951	NZFRIX010000451	3455	40116	36661
Pseudomonas aeruginosa strain WH-SGI-V-07503 WH-SGI-V-07503_contig4, whole genome shotgun sequence.	GCF0014532351	NZLLQJ010000341	53076	101168	48092
Pseudomonas aeruginosa strain AUS148 IPC388_2.1, whole genome shotgun sequence	GCF0038391451	NZNSXI010000021	273725	332325	58600
Pseudomonas aeruginosa strain AZPAE15017 AZPAE15017_contig_1, whole genome shotgun sequence.	GCF0007930051	NZJTOD010000011	39777	197252	157475
Pseudomonas aeruginosa strain PABL084 NODE_12_length_149271_cov_64.3408, whole genome shotgun sequence	GCF0034109851	NZQVBL010000121	38980	99183	60203
Pseudomonas aeruginosa strain PABL041 NODE_20_length_102633_cov_64.3107, whole genome shotgun sequence	GCF0034114651	NZQVDB010000201	31473	51274	19801
Pseudomonas aeruginosa strain WH-SGI-V-07428 WH-SGI-V-07428_contig3, whole genome shotgun sequence.	GCF0014515251	NZLLPP010000231	42148	63873	21725
Pseudomonas aeruginosa genome assembly 241_12_5Pc_6_contgs_500, contig NODE_19_length_149531_cov_20.2443_ID_37, whole genome shotgun sequence.	GCF0013737751	NZCTDK010000661	78434	98235	19801
Pseudomonas aeruginosa strain AZPAE14934 AZPAE14934_contig_12, whole genome shotgun sequence.	GCF0007939051	NZJTRH010000121	300016	324950	24934
Pseudomonas aeruginosa strain WH-SGI-V-07420 WH-SGI-V-07420_contig3, whole genome shotgun sequence.	GCF0014531451	NZLLPH010000231	43491	70655	27164
Pseudomonas aeruginosa strain 836 836_NODE_1.ctg_1, whole genome shotgun sequence.	GCF0021941351	NZNIPG010000231	444349	496342	51993
Pseudomonas aeruginosa strain F5677 chromosome, complete genome.	GCF0029469351	NZCP0266801	2509383	2532557	23174
Pseudomonas aeruginosa strain Pa124 chromosome, complete genome.	GCF0021924751	NZCP0217741	2596473	2642330	45857
Pseudomonas aeruginosa strain Zw64 IPC1384_1.1, whole genome shotgun sequence	GCF0039742051	NZRXAV010000011	325213	346938	21725
Pseudomonas aeruginosa isolate 193, whole genome shotgun sequence.	GCF9001453551	NZFRLK010000101	50644	124260	73616
Pseudomonas aeruginosa strain AA43 IPC1275_2.1, whole genome shotgun sequence	GCF0038337451	NZNSNV010000021	299584	324516	24932
Pseudomonas aeruginosa BWHPSA003 genomic scaffold adggi-supercont1.1, whole genome shotgun sequence.	GCF0004816451	NZKI5191601	1708903	1712803	3900
Pseudomonas aeruginosa strain VET-63 PA2_A7_NODE_4_length_128942_cov_22.0764_ID_7, whole genome shotgun sequence	GCF0036311551	NZRABP010002861	83286	114101	30815
Pseudomonas aeruginosa M8A.1 genomic scaffold adgfk-supercont1.2, whole genome shotgun sequence.	GCF0004806151	NZKI5187481	1689143	1711310	22167
Pseudomonas aeruginosa strain HIAE_PA02 2c, whole genome shotgun sequence.	GCF0030554051	NZQBES010000021	120191	159841	39650
Pseudomonas aeruginosa strain LIM1209 NODE_173_length_103069_cov_69.717178, whole genome shotgun sequence.	GCF0032045151	NZQJPG010001411	4734	63334	58600
Pseudomonas aeruginosa strain S426_C09_BS S426_C09_BS_NODE_4_length_435274, whole genome shotgun sequence.	GCF0021361251	NZNFGJ010000041	236962	256675	19713
Pseudomonas aeruginosa strain TNCF_175 NODE_9_length_167586_cov_13.7167_ID_17, whole genome shotgun sequence.	GCF0017660851	NZMBMQ010000361	57042	104195	47153
Pseudomonas aeruginosa strain AUS501 IPC444_1.1, whole genome shotgun sequence	GCF0039756551	NZRXEC010000011	479232	495014	15782
Pseudomonas aeruginosa strain CPHL10701 IPC738_1.1, whole genome shotgun sequence	GCF0038374651	NZNSTU010000011	350442	399657	49215
Pseudomonas aeruginosa strain AUS106 IPC355_2.1, whole genome shotgun sequence	GCF0038405851	NZNSXP010000021	406279	435443	29164
Pseudomonas aeruginosa strain B13455 GCID_CRPK_0025_NODE_4.ctg_1, whole genome shotgun sequence	GCF0039553251	NZRWXA010001351	81037	140082	59045
Pseudomonas aeruginosa PAO1 isolate 2017-C CEC16_3, whole genome shotgun sequence	GCF0039571751	NZQZFY010000031	391269	404957	13688
Pseudomonas aeruginosa isolate 276, whole genome shotgun sequence.	GCF9001460651	NZFROE010000871	7790	66835	59045
Pseudomonas aeruginosa BL14 genomic scaffold adggl-supercont1.1, whole genome shotgun sequence.	GCF0004808651	NZKI5188441	1697219	1727806	30587
Pseudomonas aeruginosa isolate PSA-15, whole genome shotgun sequence	GCF9001061951	NZFNLX010000231	346703	372352	25649
Pseudomonas aeruginosa strain PA218 NODE_1_length_1839574_cov_27.921250, whole genome shotgun sequence	GCF0097272351	NZWOAG010000011	286530	302774	16244
Pseudomonas aeruginosa CF127 genomic scaffold adgeA-supercont1.1, whole genome shotgun sequence.	GCF0004819451	NZKI5192871	1715407	1719307	3900
Pseudomonas aeruginosa strain PA-W12 IPC7_1.1, whole genome shotgun sequence	GCF0038412351	NZNTAX010000011	207813	260820	53007
Pseudomonas aeruginosa HB15 contig000001, whole genome shotgun sequence	GCF0002157953	NZAEVW030000011	304334	325007	20673
Pseudomonas aeruginosa strain PA171 contig000004, whole genome shotgun sequence.	GCF0033325651	NZQDGJ010000041	219867	240986	21119
Pseudomonas aeruginosa BL11 genomic scaffold adgfL-supercont1.1, whole genome shotgun sequence.	GCF0004809251	NZKI5188751	2549177	2606180	57003
Pseudomonas aeruginosa strain 44s031011BSL_PA2 IPC31_1.1, whole genome shotgun sequence	GCF0043756251	NZRWVE010000011	690815	714132	23317
Pseudomonas aeruginosa isolate 152, whole genome shotgun sequence.	GCF9001449551	NZFRJL010002181	7797	27598	19801
Pseudomonas aeruginosa strain AZPAE15024 AZPAE15024_contig_3, whole genome shotgun sequence.	GCF0007905851	NZJTNW010000031	135801	155602	19801
Pseudomonas aeruginosa strain 578-A scaffold_0, whole genome shotgun sequence.	GCF0023123551	NZMWYF010000011	701984	750076	48092
Pseudomonas aeruginosa strain MRSN 17623 scaffold00003, whole genome shotgun sequence.	GCF0009374952	NZJYGB020000031	733687	765635	31948
Pseudomonas aeruginosa strain MRSN 17623 scaffold00005, whole genome shotgun sequence.	GCF0009374952	NZJYGB020000051	609478	655839	46361
Pseudomonas aeruginosa strain SMC1596 IPC1618_2.1, whole genome shotgun sequence	GCF0039738251	NZRWZN010000021	308331	325154	16823
Pseudomonas aeruginosa strain 6092.3 IPC1340_3.1, whole genome shotgun sequence	GCF0043719751	NZRWNV010000031	327650	347185	19535
Pseudomonas aeruginosa strain AZPAE14824 AZPAE14824_contig_2, whole genome shotgun sequence.	GCF0007953051	NZJTVK010000021	39285	98338	59053
Pseudomonas aeruginosa strain NHmuc, complete genome.	GCF0019002651	NZCP0134791	3498929	3526672	27743
Pseudomonas aeruginosa strain PA100 contig000001, whole genome shotgun sequence.	GCF0033325351	NZQDGV010000011	516662	544240	27578
Pseudomonas aeruginosa strain 32SP IPC579_3.1, whole genome shotgun sequence	GCF0043729151	NZRWQR010000031	183079	213866	30787
Pseudomonas aeruginosa strain LIM1136 NODE_53_length_193883_cov_60.131832, whole genome shotgun sequence.	GCF0032043651	NZQJPA010000461	44011	102611	58600
Pseudomonas aeruginosa strain PAC95B IPC183_1.1, whole genome shotgun sequence	GCF0043729351	NZRWQX010000011	556440	600048	43608
Pseudomonas aeruginosa strain PA-W8 IPC4_1.1, whole genome shotgun sequence	GCF0038417551	NZNTBA010000011	318329	356119	37790
Pseudomonas aeruginosa BL18 genomic scaffold adgey-supercont1.1, whole genome shotgun sequence.	GCF0004807851	NZKI5188191	1704716	1722803	18087
Pseudomonas aeruginosa isolate PSA-12, whole genome shotgun sequence	GCF9001061451	NZFNLT010000261	315968	348625	32657
Pseudomonas aeruginosa BL09 genomic scaffold adgge-supercont1.1, whole genome shotgun sequence.	GCF0004809651	NZKI5188861	770960	786033	15073
Pseudomonas aeruginosa strain NCTC11839, whole genome shotgun sequence	GCF9014825351	NZCABEEV0100000081	4249387	4266210	16823
Pseudomonas aeruginosa strain NCTC13618 genome assembly, chromosome: 1	GCF9014725951	NZLR5904741	2466411	2513296	46885
Pseudomonas aeruginosa strain PA_D2, complete genome.	GCF0017217651	NZCP0125781	2518245	2544572	26327
Pseudomonas aeruginosa isolate 89, whole genome shotgun sequence.	GCF9001443251	NZFRHI010000241	103965	126639	22674
Pseudomonas aeruginosa strain env100 NODE_2_length_358429_cov_5.61497, whole genome shotgun sequence.	GCF0023308051	NZNRBB010000021	209003	225331	16328
Pseudomonas aeruginosa strain PA176 NODE_21_length_109743_cov_20.036309, whole genome shotgun sequence	GCF0097274051	NZWOAR010000211	35121	48337	13216
Pseudomonas aeruginosa strain CFSAN084950 chromosome, complete genome	GCF0096488751	NZCP0457681	1437729	1448206	10477
Pseudomonas aeruginosa strain WH-SGI-V-07050 WH-SGI-V-07050_contig1, whole genome shotgun sequence.	GCF0014494351	NZLLLT010000011	735727	751883	16156
Pseudomonas aeruginosa strain 12939 chromosome, complete genome.	GCF0027536551	NZCP0244771	2424330	2436621	12291
Pseudomonas aeruginosa strain T52373, complete genome.	GCF0015160051	NZCP0088671	4876118	4896136	20018
Pseudomonas aeruginosa strain AZPAE14923 AZPAE14923_contig_28, whole genome shotgun sequence.	GCF0007912051	NZJTRS010000281	121308	179979	58671
Pseudomonas aeruginosa strain 838 838_NODE_2.ctg_1, whole genome shotgun sequence.	GCF0021940251	NZNIPI010000191	231498	245362	13864
Pseudomonas aeruginosa strain PA-W7 IPC3_2.1, whole genome shotgun sequence	GCF0038413051	NZNTBB010000021	24260	49908	25648
Pseudomonas aeruginosa strain DSM 50071 3_801891_19.1347, whole genome shotgun sequence.	GCF0010429251	NZJYLC010000031	479000	493273	14273
Pseudomonas aeruginosa strain AUS226 IPC252_2.1, whole genome shotgun sequence	GCF0039766651	NZRXFE010000021	471749	482058	10309
Pseudomonas aeruginosa strain AZPAE15011 AZPAE15011_contig_5, whole genome shotgun sequence.	GCF0007928851	NZJTOJ010000051	287586	307387	19801
Pseudomonas aeruginosa strain 3141 IPC1105_2.1, whole genome shotgun sequence	GCF0039760751	NZRXCP010000021	42262	220412	178150
Pseudomonas aeruginosa strain SCH_ABX09 ABX09_contig000009, whole genome shotgun sequence.	GCF0020012251	NZMVBP010000091	84697	101525	16828
Pseudomonas aeruginosa strain AZPAE14716 AZPAE14716_contig_20, whole genome shotgun sequence.	GCF0007955351	NZJTWQ010000201	116838	182870	66032
Pseudomonas aeruginosa PA96 genome	GCF0006266551	NZCP0072241	2365541	2384053	18512
Pseudomonas aeruginosa isolate 190, whole genome shotgun sequence.	GCF9001453251	NZFRLJ010001181	7787	34372	26585
Pseudomonas aeruginosa strain 358 scaffold_4, whole genome shotgun sequence.	GCF0023123751	NZMWYG010000051	40010	88102	48092
Pseudomonas aeruginosa strain WH-SGI-V-07241 WH-SGI-V-07241_contig15, whole genome shotgun sequence.	GCF0014509351	NZLLNM010000071	45282	66910	21628
Pseudomonas aeruginosa isolate 241.1, whole genome shotgun sequence.	GCF9001478551	NZFRUX010000521	7776	23391	15615
Pseudomonas aeruginosa strain PABL108 NODE_15_length_98532_cov_77.394, whole genome shotgun sequence	GCF0034104851	NZQVAP010000151	39287	48514	9227
Pseudomonas aeruginosa strain WH-SGI-V-07374 WH-SGI-V-07374_contig10, whole genome shotgun sequence.	GCF0014501951	NZLLNY010000021	146930	160794	13864
Pseudomonas aeruginosa strain Env_16 contig-2000003, whole genome shotgun sequence.	GCF0022395351	NZNLBC010000061	422377	438159	15782
Pseudomonas aeruginosa strain 712 scaffold_0, whole genome shotgun sequence.	GCF0023120951	NZMWXH010000011	593674	641766	48092
Pseudomonas aeruginosa strain PA_D5, complete genome.	GCF0017220251	NZCP0125791	2518245	2544571	26326
Pseudomonas aeruginosa PAO581	GCF0004685551	NZCP0067051	2859444	2878979	19535
Pseudomonas aeruginosa strain 5034388513 IPC1491_2.1, whole genome shotgun sequence	GCF0043706051	NZRWMZ010000021	207738	260745	53007
Pseudomonas aeruginosa strain 211BR IPC1242_8.1, whole genome shotgun sequence	GCF0038341351	NZNSOA010000081	166156	224757	58601
Pseudomonas aeruginosa strain Us411 IPC860_2.1, whole genome shotgun sequence	GCF0038373751	NZNSSX010000021	42208	96159	53951
Pseudomonas aeruginosa strain PSEUDO-LEB NODE_12_length_185099_cov_34.2077_ID_2038, whole genome shotgun sequence.	GCF0019379751	NZMLQX010000121	122353	141800	19447
Pseudomonas aeruginosa strain NCTC10730, whole genome shotgun sequence.	GCF9004554251	NZUGUH010000011	1237211	1257994	20783
Pseudomonas aeruginosa strain 205BR IPC1243_2.1, whole genome shotgun sequence	GCF0038338851	NZNSNZ010000021	385731	444331	58600
Pseudomonas aeruginosa strain SJU-S79_2 NODE_9_length_283667_cov_59.6668, whole genome shotgun sequence.	GCF0023300051	NZNREZ010000091	206729	221902	15173
Pseudomonas aeruginosa strain AMT0026-2 IPC554_1.1, whole genome shotgun sequence	GCF0039754251	NZRXDJ010000011	347334	372982	25648
Pseudomonas aeruginosa strain 1638 1638_NODE_10_length_243424_cov_122.737, whole genome shotgun sequence	GCF0038635551	NZRRBP010000101	43241	67046	23805
Pseudomonas aeruginosa strain HUM-320-D1 PA3_F10_NODE_22_length_99176_cov_25.6203_ID_43, whole genome shotgun sequence	GCF0036317351	NZRAAI010000031	4725	65904	61179
Pseudomonas aeruginosa strain WCHPA075025, whole genome shotgun sequence.	GCF0029803851	NZPPDT010000031	41962	105350	63388
Pseudomonas aeruginosa genome assembly 279_15_211Gc_contgs_500, contig NODE_12_length_144026_cov_27.0658_ID_23, whole genome shotgun sequence.	GCF0013740751	NZCTFI010000111	44876	64861	19985
Pseudomonas denitrificans strain 90_PDEN 936_78414_1060918_533+,...,526+, whole genome shotgun sequence.	GCF0010678151	NZJUOT010001531	61279	70613	9334
Pseudomonas aeruginosa strain 259S240811BSL_PA2 IPC55_2.1, whole genome shotgun sequence	GCF0043751151	NZRWUJ010000021	124061	178000	53939
Pseudomonas aeruginosa isolate 326, whole genome shotgun sequence.	GCF9001465551	NZFRQB010000041	176533	241423	64890
Pseudomonas aeruginosa strain AZPAE15023 AZPAE15023_contig_8, whole genome shotgun sequence.	GCF0007931251	NZJTNX010000081	85615	109025	23410
Pseudomonas aeruginosa strain AUS339 IPC292_2.1, whole genome shotgun sequence	GCF0038395251	NZNSYM010000021	91333	149780	58447
Pseudomonas aeruginosa strain MCF922 IPC1362_4.1, whole genome shotgun sequence	GCF0039747251	NZRXBK010000041	87478	121960	34482
Pseudomonas aeruginosa strain TNCF_165 NODE_17_length_113626_cov_7.77797_ID_33, whole genome shotgun sequence.	GCF0017659851	NZMBMM010000341	43491	90644	47153
Pseudomonas aeruginosa strain M67 NODE_25_length_81349_cov_29.0979, whole genome shotgun sequence	GCF0041233451	NZSDVE010000251	38144	63434	25290
Pseudomonas aeruginosa strain KCRI-242 isolate R0008_242, whole genome shotgun sequence.	GCF9004068451	NZOVCQ010000061	127729	146231	18502
Pseudomonas aeruginosa strain AZPAE14404 AZPAE14404_contig_1, whole genome shotgun sequence.	GCF0007961451	NZJTYN010000011	306399	322696	16297
Pseudomonas aeruginosa strain ATCC BAA-2108 IPC1576_3.1, whole genome shotgun sequence.	GCF0022370251	NZMVGV010000031	271155	290869	19714
Pseudomonas aeruginosa genome assembly 266_15Pc_7_contgs_500, contig NODE_2_length_451159_cov_19.834_ID_3, whole genome shotgun sequence.	GCF0013751151	NZCTEU010000391	78434	98235	19801
Pseudomonas aeruginosa strain H25883 chromosome, complete genome	GCF0037981251	NZCP0336861	2506759	2536652	29893
Pseudomonas aeruginosa isolate 186, whole genome shotgun sequence.	GCF9001452951	NZFRLE010000831	23886	56318	32432
Pseudomonas aeruginosa genome assembly 256_15_311Gb_contgs_500, contig NODE_18_length_132268_cov_22.0409_ID_35, whole genome shotgun sequence.	GCF0013740151	NZCTDS010000381	61156	80957	19801
Pseudomonas aeruginosa strain AUS306 IPC294_3.1, whole genome shotgun sequence	GCF0038407151	NZNSYL010000031	42172	108746	66574
Pseudomonas aeruginosa strain WH-SGI-V-07375 WH-SGI-V-07375_contig6, whole genome shotgun sequence.	GCF0014502251	NZLLNZ010000531	321506	336671	15165
Pseudomonas aeruginosa strain AZPAE14821 AZPAE14821_contig_16, whole genome shotgun sequence.	GCF0007952351	NZJTVN010000161	157687	210463	52776
Pseudomonas aeruginosa strain 5024382749-13 IPC1505_11.1, whole genome shotgun sequence	GCF0043710651	NZRWMN010000111	171405	200569	29164
Pseudomonas aeruginosa strain PA175 contig000002, whole genome shotgun sequence.	GCF0033324551	NZQDGI010000021	515189	524416	9227
Pseudomonas aeruginosa HB13 strain 138244 contig000003, whole genome shotgun sequence	GCF0002157753	NZAEVV030000031	231242	245105	13863
Pseudomonas aeruginosa strain PA198 NODE_19_length_136577_cov_21.814254, whole genome shotgun sequence	GCF0097273251	NZWOAL010000191	26232	86417	60185
Pseudomonas aeruginosa, whole genome shotgun sequence.	GCF0007517151	NZCCVU010000011	4541071	4608978	67907
Pseudomonas aeruginosa strain L10 chromosome, complete genome.	GCF0022238051	NZCP0193381	2530411	2550212	19801
Pseudomonas aeruginosa strain GO77 NODE_1_length_584169_cov_38.105518, whole genome shotgun sequence	GCF0070044651	NZVJMU010000011	299524	321153	21629
Pseudomonas aeruginosa strain env331b NODE_5_length_326850_cov_14.1421, whole genome shotgun sequence.	GCF0023265951	NZNQZY010000051	186470	201179	14709
Pseudomonas aeruginosa strain 5 IPC1587_4.1, whole genome shotgun sequence	GCF0043701451	NZRWLQ010000041	191532	245471	53939
Pseudomonas aeruginosa strain AUS631 IPC460_5.1, whole genome shotgun sequence	GCF0038404451	NZNSWR010000051	44125	107111	62986
Pseudomonas aeruginosa strain AUS066 IPC345_1.1, whole genome shotgun sequence	GCF0038393051	NZNSXW010000011	592870	616282	23412
Pseudomonas aeruginosa strain WH-SGI-V-07283 WH_SGI_V_07283_16, whole genome shotgun sequence.	GCF0014546651	NZLLUJ010000211	42301	69590	27289
Pseudomonas aeruginosa strain NCTC13717, whole genome shotgun sequence.	GCF9004553651	NZUAUC010000081	64529	113975	49446
Pseudomonas aeruginosa strain AZPAE15010 AZPAE15010_contig_29, whole genome shotgun sequence.	GCF0007928551	NZJTOK010000291	13466	33176	19710
Pseudomonas aeruginosa strain W91453 contig3, whole genome shotgun sequence.	GCF0029271351	NZJPFG010000031	268243	356659	88416
Pseudomonas aeruginosa strain AUS207 IPC226_3.1, whole genome shotgun sequence	GCF0038398651	NZNSZJ010000031	311923	337569	25646
Pseudomonas aeruginosa BL21 genomic scaffold adgep-supercont1.1, whole genome shotgun sequence.	GCF0004807251	NZKI5187931	2573952	2592464	18512
Pseudomonas aeruginosa strain J9UH1F IPC742_6.1, whole genome shotgun sequence	GCF0038365751	NZNSTS010000061	36375	75187	38812
Pseudomonas aeruginosa strain 2328 2328_NODE_10.ctg_1, whole genome shotgun sequence.	GCF0021936651	NZNIOP010000801	117434	138762	21328
Pseudomonas aeruginosa PAO1 isolate 2017-G CEC21_25, whole genome shotgun sequence	GCF0039570851	NZQZGC010000251	39325	53013	13688
Pseudomonas aeruginosa C40 genomic scaffold adgfO-supercont1.1, whole genome shotgun sequence.	GCF0004804751	NZKI5187121	1693277	1713623	20346
Pseudomonas aeruginosa strain CCBH5939 scaffold9.1, whole genome shotgun sequence	GCF0041528251	NZSEME010000091	44010	102610	58600
Pseudomonas aeruginosa strain ATCC 33357 scaffold_36, whole genome shotgun sequence.	GCF0014448351	NZLJZD010001391	45344	70996	25652
Pseudomonas aeruginosa strain AMT0046-1 IPC560_5.1, whole genome shotgun sequence	GCF0038385051	NZNSVM010000051	42197	51951	9754
Pseudomonas aeruginosa strain AUS157 IPC396_2.1, whole genome shotgun sequence	GCF0039757651	NZRXEL010000021	480632	503339	22707
Pseudomonas aeruginosa isolate 284, whole genome shotgun sequence.	GCF9001461451	NZFRON010000641	98593	163485	64892
Pseudomonas aeruginosa strain WH-SGI-V-07642 WH-SGI-V-07642_contig7, whole genome shotgun sequence.	GCF0014522351	NZLLRN010000871	99107	112970	13863
Pseudomonas aeruginosa strain 1714 1714_NODE_3_length_396603_cov_98.1906, whole genome shotgun sequence	GCF0038636851	NZRRBZ010000021	262016	316494	54478
Pseudomonas aeruginosa BL04 genomic scaffold adgfK-supercont1.1, whole genome shotgun sequence.	GCF0004810651	NZKI5189311	1878603	1961814	83211
Pseudomonas aeruginosa BWHPSA024 genomic scaffold adgfW-supercont1.1, whole genome shotgun sequence.	GCF0004812251	NZKI5189961	2177658	2225753	48095
Pseudomonas aeruginosa strain CF27 IPC1173_1.1, whole genome shotgun sequence	GCF0038343051	NZNSOU010000011	382234	401945	19711
Pseudomonas aeruginosa PA1R, complete genome.	GCF0004966451	NC0228061	657872	682263	24391
Pseudomonas aeruginosa strain CPHL6749 IPC731_3.1, whole genome shotgun sequence	GCF0038366451	NZNSTZ010000031	221875	243598	21723
Pseudomonas aeruginosa strain PAC70B IPC166_1.1, whole genome shotgun sequence	GCF0043731951	NZRWRO010000011	782575	817081	34506
Pseudomonas aeruginosa isolate 87, whole genome shotgun sequence.	GCF9001442951	NZFRHH010000211	7791	24618	16827
Pseudomonas aeruginosa isolate 149, whole genome shotgun sequence.	GCF9001449151	NZFRJG010000181	7780	27581	19801
Pseudomonas aeruginosa strain WH-SGI-V-07311 WH_SGI_V_07311_5, whole genome shotgun sequence	GCF0014547451	NZLLVA010000451	435267	491043	55776
Pseudomonas aeruginosa isolate 197, whole genome shotgun sequence.	GCF9001454151	NZFRLQ010001811	4500	26128	21628
Pseudomonas aeruginosa BL13 genomic scaffold adgfQ-supercont1.1, whole genome shotgun sequence.	GCF0004808851	NZKI5188521	2700437	2766439	66002
Pseudomonas aeruginosa strain Lo049 scaffold2.1, whole genome shotgun sequence.	GCF0017563551	NZLZQE010000121	42262	139804	97542
Pseudomonas aeruginosa strain CLJ3 contig046, whole genome shotgun sequence.	GCF0030575951	NZPZJI010000461	46685	63115	16430
Pseudomonas aeruginosa strain 6 IPC1588_3.1, whole genome shotgun sequence	GCF0043701251	NZRWLP010000031	347788	369812	22024
Pseudomonas aeruginosa strain AUS462 IPC266_1.1, whole genome shotgun sequence	GCF0038409451	NZNSYX010000011	421746	484596	62850
Pseudomonas aeruginosa strain JYH11 IPC1222_1.1, whole genome shotgun sequence	GCF0039758451	NZRXBW010000011	324068	340360	16292
Pseudomonas aeruginosa strain HUM-334 NODE_12_length_121192_cov_11.4455_ID_23, whole genome shotgun sequence	GCF0036314551	NZRAAZ010000491	44906	66685	21779
Pseudomonas aeruginosa strain PT31M IPC881_2.1, whole genome shotgun sequence	GCF0038362251	NZNSSQ010000021	305000	358939	53939
Pseudomonas aeruginosa strain MRSN16847 MRSN16847_contig00002, whole genome shotgun sequence	GCF0039697351	NZRXVN010000021	139056	230797	91741
Pseudomonas aeruginosa strain LiA133_2003 IPC776_5.1, whole genome shotgun sequence	GCF0038365251	NZNSTK010000051	87169	106062	18893
Pseudomonas aeruginosa strain SF4, whole genome shotgun sequence	GCF0078602751	NZSZXQ010000011	346575	372224	25649
Pseudomonas aeruginosa strain 5034388498-21 IPC1486_4.1, whole genome shotgun sequence	GCF0043712451	NZRWNE010000041	421272	483204	61932
Pseudomonas aeruginosa C48 genomic scaffold adgeZ-supercont1.1, whole genome shotgun sequence.	GCF0004804351	NZKI5187031	2408718	2431888	23170
Pseudomonas aeruginosa strain PA32 contig000002, whole genome shotgun sequence.	GCF0033327351	NZQDGX010000021	232291	298332	66041
Pseudomonas aeruginosa BWHPSA042 adkfZ-supercont1.1, whole genome shotgun sequence.	GCF0005203551	NZKI9145121	1676205	1697161	20956
Pseudomonas aeruginosa strain 1334/14 chromosome, complete genome	GCF0041937351	NZCP0357391	1526017	1542764	16747
Pseudomonas aeruginosa PS42 adkgl-supercont1.1, whole genome shotgun sequence.	GCF0005201951	NZKI9144371	1720625	1737670	17045
Pseudomonas aeruginosa strain AZPAE14963 AZPAE14693_contig_26_Average_coverage:_94.97, whole genome shotgun sequence.	GCF0007918251	NZJTQE010000261	39295	57807	18512
Pseudomonas aeruginosa strain AUS277 IPC317_3.1, whole genome shotgun sequence	GCF0039765651	NZRXFA010000031	307937	327329	19392
Pseudomonas aeruginosa C51 genomic scaffold adgeS-supercont1.5, whole genome shotgun sequence.	GCF0004804151	NZKI5186981	30343	34243	3900
Pseudomonas aeruginosa strain MRSN16383 MRSN16383_contig00001, whole genome shotgun sequence	GCF0039693551	NZRXVQ010000011	368376	384703	16327
Pseudomonas aeruginosa strain SMC4386_delta_CRISPR_Cas contig_173, whole genome shotgun sequence.	GCF0014828651	NZLORA010001731	114389	148339	33950
Pseudomonas aeruginosa isolate 172, whole genome shotgun sequence.	GCF9001451451	NZFRKP010000041	7781	27582	19801
Pseudomonas aeruginosa strain LMG5031 IPC878_7.1, whole genome shotgun sequence	GCF0038372451	NZNSST010000071	41715	55645	13930
Pseudomonas aeruginosa strain 6097.3 IPC1346_2.1, whole genome shotgun sequence	GCF0043708151	NZRWNQ010000021	131718	151779	20061
Pseudomonas aeruginosa strain HUM-277 NODE_14_length_143759_cov_23.0871_ID_27, whole genome shotgun sequence	GCF0036318951	NZQZZY010000231	4638	65799	61161
Pseudomonas aeruginosa strain HUM-280 PA3_G6_NODE_13_length_172565_cov_33.2233_ID_25, whole genome shotgun sequence	GCF0036319251	NZQZZV010000661	28639	89818	61179
Pseudomonas aeruginosa strain 57RV IPC586_3.1, whole genome shotgun sequence	GCF0043726151	NZRWQN010000031	186115	216902	30787
Pseudomonas aeruginosa genome assembly 245_Tsb_Pool_contgs_500, contig NODE_17_length_149523_cov_32.3694_ID_33, whole genome shotgun sequence.	GCF0013738551	NZCTDL010000161	78411	98212	19801
Pseudomonas aeruginosa strain AUS460 IPC280_2.1, whole genome shotgun sequence	GCF0038408351	NZNSYQ010000021	310099	369850	59751
Pseudomonas aeruginosa strain MRSN17849 MRSN17849_contig00005, whole genome shotgun sequence	GCF0039692551	NZRXVK010000051	32301	54396	22095
Pseudomonas aeruginosa isolate 128, whole genome shotgun sequence.	GCF9001447151	NZFRIZ010000371	103525	140186	36661
Pseudomonas aeruginosa strain ATCC 15692, complete genome.	GCF0017295051	NZCP0171491	2415522	2429210	13688
Pseudomonas aeruginosa strain env108 NODE_3_length_589315_cov_8.3155, whole genome shotgun sequence.	GCF0023307251	NZNRAV010000031	245746	260006	14260
Pseudomonas aeruginosa strain UMB7777 NODE_20_length_85427_cov_6.044900, whole genome shotgun sequence	GCF0098075451	NZWUDC010000201	24499	72591	48092
Pseudomonas aeruginosa isolate 168, whole genome shotgun sequence.	GCF9001451051	NZFRKG010000171	211821	237469	25648
Pseudomonas aeruginosa BWHPSA046 adkgc-supercont1.2, whole genome shotgun sequence.	GCF0005202751	NZKI9144681	1572699	1619850	47151
Pseudomonas aeruginosa strain PAC108A IPC158_2.1, whole genome shotgun sequence	GCF0043737551	NZRWRV010000021	299803	353742	53939
Pseudomonas aeruginosa strain AMT0046-109 IPC563_2.1, whole genome shotgun sequence	GCF0038384051	NZNSVL010000021	476606	501301	24695
Pseudomonas aeruginosa strain delta6_4 chromosome	GCF0098000251	NZCP0470631	3079836	3099371	19535
Pseudomonas aeruginosa strain K34-7 chromosome, complete genome.	GCF0032065351	NZCP0297071	1051802	1101249	49447
Pseudomonas aeruginosa strain AZPAE14897 AZPAE14897_contig_7, whole genome shotgun sequence.	GCF0007910251	NZJTSS010000071	110265	148051	37786
Pseudomonas aeruginosa strain UQCCR 393788042 K AB94 NODE_14_length_146194_cov_16.346, whole genome shotgun sequence.	GCF0020882151	NZMWWM010000141	45134	106294	61160
Pseudomonas aeruginosa strain PB354 chromosome, complete genome.	GCF0028128851	NZCP0250531	2463610	2514391	50781
Pseudomonas aeruginosa strain AUS422 IPC491_2.1, whole genome shotgun sequence	GCF0038387651	NZNSWE010000021	618442	657967	39525
Pseudomonas aeruginosa strain 2042723558 IPC1504_1.1, whole genome shotgun sequence	GCF0043711451	NZRWMO010000011	433328	481423	48095
Pseudomonas aeruginosa isolate paerg012 genome assembly, chromosome: 0	GCF9006183351	NZLR1305371	2371941	2410964	39023
Pseudomonas aeruginosa strain delta6_5 chromosome	GCF0098000451	NZCP0470641	3079854	3099389	19535
Pseudomonas aeruginosa genome assembly 260_Rw199_contgs_500, contig NODE_19_length_149523_cov_37.8728_ID_37, whole genome shotgun sequence.	GCF0013749951	NZCTDV010000151	78411	98212	19801
Pseudomonas aeruginosa str. Stone 130 genomic scaffold aczIk-supercont1.1, whole genome shotgun sequence.	GCF0004784652	NZKI5173481	803375	917027	113652
Pseudomonas aeruginosa strain PAH13 scaffold_0, whole genome shotgun sequence	GCF0022832951	NZNQWG010000011	478847	531600	52753
Pseudomonas aeruginosa strain AUS489 IPC438_2.1, whole genome shotgun sequence	GCF0038389351	NZNSWY010000021	317562	348334	30772
Pseudomonas aeruginosa genome assembly 214_Tsb_9_contgs_500, contig NODE_18_length_149523_cov_34.5264_ID_35, whole genome shotgun sequence.	GCF0013744751	NZCUXA010000271	78411	98212	19801
Pseudomonas aeruginosa isolate 346, whole genome shotgun sequence.	GCF9001467451	NZFRQT010000231	346862	372510	25648
Pseudomonas aeruginosa strain AZPAE14847 AZPAE14847_contig_8, whole genome shotgun sequence.	GCF0007897551	NZJTUN010000081	258508	294203	35695
Pseudomonas aeruginosa strain AU10502 NODE_3_length_579878_cov_5.7401_ID_5, whole genome shotgun sequence.	GCF0015548551	NZLRZK010000331	359688	419353	59665
Pseudomonas aeruginosa strain env204 NODE_6_length_311453_cov_17.3402, whole genome shotgun sequence.	GCF0023301751	NZNRFX010000061	119192	147643	28451
Pseudomonas aeruginosa strain WH-SGI-V-07629 WH-SGI-V-07629_contig1, whole genome shotgun sequence.	GCF0014533851	NZLLRA010000011	42155	96094	53939
Pseudomonas aeruginosa genome assembly 213_Tsb_1_contgs_500, contig NODE_3_length_451136_cov_24.3318_ID_5, whole genome shotgun sequence.	GCF0013736151	NZCTCQ010000321	78411	98212	19801
Pseudomonas aeruginosa isolate 148, whole genome shotgun sequence.	GCF9001449051	NZFRJH010000871	100494	115252	14758
Pseudomonas sp. HMSC057H01 Scaffold398, whole genome shotgun sequence.	GCF0018364051	NZKV8285121	204872	230544	25672
Pseudomonas aeruginosa strain HUM-272 PA3_H5_NODE_3_length_337196_cov_52.6345_ID_5, whole genome shotgun sequence	GCF0036299851	NZRADV010000761	198406	216649	18243
Pseudomonas aeruginosa strain 36BR IPC1246_1.1, whole genome shotgun sequence	GCF0038341951	NZNSNW010000011	166156	224756	58600
Pseudomonas aeruginosa strain AUS141 IPC382_3.1, whole genome shotgun sequence	GCF0039768051	NZRXEP010000031	328976	348687	19711
Pseudomonas aeruginosa strain VD706 scaffold_1, whole genome shotgun sequence.	GCF0023127651	NZMWYS010000021	409255	448864	39609
Pseudomonas aeruginosa strain 298S020611BSL_PA1 IPC68_2.1, whole genome shotgun sequence	GCF0043743151	NZRWTY010000021	144096	192188	48092
Pseudomonas aeruginosa strain CLJ1 contig16, whole genome shotgun sequence.	GCF0030323951	NZPVXJ010000161	310994	327424	16430
Pseudomonas aeruginosa isolate 239, whole genome shotgun sequence.	GCF9001457351	NZFRMX010000641	475573	491188	15615
Pseudomonas aeruginosa strain 585 scaffold_0, whole genome shotgun sequence.	GCF0023124651	NZMWYL010000011	339677	362506	22829
Pseudomonas aeruginosa strain WH-SGI-V-07681 WH-SGI-V-07681_contig15, whole genome shotgun sequence.	GCF0014524151	NZLLSB010000071	52966	113693	60727
Pseudomonas aeruginosa strain AU11990 NODE_1_length_888465_cov_7.07056_ID_1, whole genome shotgun sequence.	GCF0015552551	NZLRZL010000111	359686	419356	59670
Pseudomonas aeruginosa strain AZPAE14982 AZPAE14982_contig_3, whole genome shotgun sequence.	GCF0007922851	NZJTPM010000031	7114	24058	16944
Pseudomonas aeruginosa strain NCTC12903 genome assembly, chromosome: 1	GCF9006367551	NZLR1343091	2364949	2368849	3900
Pseudomonas aeruginosa strain PA_150577 chromosome, complete genome.	GCF0024428551	NZCP0173061	2417678	2430988	13310
Pseudomonas aeruginosa strain AUS504 IPC297_2.1, whole genome shotgun sequence	GCF0038394751	NZNSYJ010000021	470220	484084	13864
Pseudomonas aeruginosa strain FDAARGOS_532 chromosome, complete genome	GCF0038121651	NZCP0337711	733619	743366	9747
Pseudomonas aeruginosa strain TNCF_23 NODE_4_length_484752_cov_15.4446_ID_7, whole genome shotgun sequence.	GCF0017655951	NZMAZJ010000181	247026	294177	47151
Pseudomonas aeruginosa BWHPSA038 adkfW-supercont1.1, whole genome shotgun sequence.	GCF0005204351	NZKI9145401	2166311	2197506	31195
Pseudomonas aeruginosa strain TNCF_151M NODE_22_length_102574_cov_8.80952_ID_43, whole genome shotgun sequence.	GCF0017659251	NZMBMI010000351	43356	90507	47151
Pseudomonas aeruginosa strain MRSN 17623 contig00012, whole genome shotgun sequence	GCF0009374951	NZJYGB010000121	52715	93229	40514
Pseudomonas aeruginosa strain MRSN 17623 contig00019, whole genome shotgun sequence	GCF0009374951	NZJYGB010000191	74631	101760	27129
Pseudomonas aeruginosa strain MRSN13488 MRSN13488_contig00005, whole genome shotgun sequence	GCF0039699751	NZRXWF010000051	466224	479060	12836
Pseudomonas aeruginosa BL08 genomic scaffold adgeD-supercont1.3, whole genome shotgun sequence.	GCF0004809851	NZKI5188991	120174	149398	29224
Pseudomonas aeruginosa strain TNCF_4M NODE_18_length_93151_cov_6.06787_ID_35, whole genome shotgun sequence.	GCF0017654351	NZMAUP010000601	33938	81089	47151
Pseudomonas aeruginosa BL24 genomic scaffold adgeY-supercont1.2, whole genome shotgun sequence.	GCF0004806651	NZKI5187581	2482793	2486693	3900
Pseudomonas aeruginosa strain PAC10B IPC125_1.1, whole genome shotgun sequence	GCF0043740951	NZRWTA010000011	701965	750057	48092
Pseudomonas aeruginosa strain AZPAE14379 AZPAE14379_contig_2, whole genome shotgun sequence.	GCF0007959251	NZJTYW010000021	477311	522166	44855
Pseudomonas aeruginosa LESlike5 sequence.	GCF0005838951	NZCP0069801	2503877	2550737	46860
Pseudomonas aeruginosa strain ATCC 9027 scaffold_5, whole genome shotgun sequence.	GCF0012946751	NZLJGL010000061	66418	127732	61314
Pseudomonas aeruginosa strain Liverpool Epidemic Strain, whole genome shotgun sequence.	GCF0008244451	NZCCVT010000031	38150	124180	86030
Pseudomonas aeruginosa strain 3C1A isolate Jpn1563 IPC91_1.1, whole genome shotgun sequence	GCF0036987151	NZMCMS010000011	368460	384788	16328
Pseudomonas aeruginosa genome assembly 282_Rw110_contgs_500, contig NODE_2_length_371363_cov_27.9145_ID_3, whole genome shotgun sequence.	GCF0013741151	NZCTFJ010000701	267227	277969	10742
Pseudomonas aeruginosa strain PA_D9, complete genome.	GCF0017217851	NZCP0125801	3101940	3128267	26327
Pseudomonas aeruginosa strain SCH_ABX07 ABX07_contig000001, whole genome shotgun sequence.	GCF0020013851	NZMVBR010000011	148174	174977	26803
Pseudomonas aeruginosa strain AUS307 IPC507_6.1, whole genome shotgun sequence	GCF0038386451	NZNSVZ010000061	59640	99290	39650
Pseudomonas aeruginosa strain TNCF_133_1 NODE_6_length_358214_cov_21.1758_ID_11, whole genome shotgun sequence.	GCF0017655351	NZMAZE010000141	120470	167621	47151
Pseudomonas aeruginosa strain PB369 chromosome, complete genome.	GCF0028128251	NZCP0250491	2511437	2538250	26813
Pseudomonas aeruginosa 148 contig_35, whole genome shotgun sequence	GCF0006475951	NZATAJ010000581	8357	17584	9227
Pseudomonas aeruginosa genome assembly 238_2_5Pc_2_contgs_500, contig NODE_2_length_451136_cov_24.0135_ID_3, whole genome shotgun sequence.	GCF0013737151	NZCTDG010000601	78411	98212	19801
Pseudomonas sp. HMSC058A10 Scaffold333, whole genome shotgun sequence.	GCF0018099351	NZKV7994501	475687	532439	56752
Pseudomonas aeruginosa strain AUS345 IPC496_1.1, whole genome shotgun sequence	GCF0038387051	NZNSWB010000011	44992	80209	35217
Pseudomonas aeruginosa isolate paerg002 genome assembly, chromosome: 0	GCF9006182551	NZLR1305271	5486399	5525420	39021
Pseudomonas aeruginosa strain H26027 chromosome, complete genome	GCF0037981051	NZCP0336841	2681823	2729915	48092
Pseudomonas aeruginosa strain HUM-274 PA3_B6_NODE_19_length_117684_cov_24.6023_ID_37, whole genome shotgun sequence	GCF0036328651	NZRAAJ010000531	51382	106714	55332
Pseudomonas aeruginosa strain Liverpool Epidemic Strain, whole genome shotgun sequence.	GCF0008241051	NZCCOD010000031	37741	121242	83501
Pseudomonas aeruginosa strain HB392 IPC1191_2.1, whole genome shotgun sequence	GCF0038339051	NZNSON010000021	42262	104009	61747
Pseudomonas aeruginosa strain HUM-262 PA3_G4_NODE_15_length_143641_cov_27.991_ID_29, whole genome shotgun sequence	GCF0036319051	NZQZZW010000681	38237	93569	55332
Pseudomonas aeruginosa strain HUM-282 PA3_H6_NODE_3_length_447017_cov_37.2644_ID_5, whole genome shotgun sequence	GCF0036331951	NZQZYP010000061	381502	397284	15782
Pseudomonas aeruginosa isolate 412, whole genome shotgun sequence.	GCF9001473851	NZFRTH010000481	98877	118588	19711
Pseudomonas aeruginosa strain Ocean-1170 unitig_0, whole genome shotgun sequence.	GCF0022635451	NZNMRU010000011	1244900	1278478	33578
Pseudomonas aeruginosa strain 2320 2320_NODE_1.ctg_1, whole genome shotgun sequence.	GCF0021936551	NZNIOM010000881	246619	266421	19802
Pseudomonas aeruginosa genome assembly 261_Tsb_5_contgs_500, contig NODE_16_length_149523_cov_24.8725_ID_31, whole genome shotgun sequence.	GCF0013750151	NZCTES010000641	78411	98212	19801
Pseudomonas aeruginosa strain HS9 chromosome, complete genome.	GCF0033192351	NZCP0308611	6727326	6780054	52728
Pseudomonas aeruginosa genome assembly 220_15_221Ga_contgs_500, contig NODE_18_length_149523_cov_24.4853_ID_35, whole genome shotgun sequence.	GCF0013745951	NZCTCT010000371	78411	98212	19801
Pseudomonas aeruginosa strain Ocean-100 scaffold11_cov340_read216, whole genome shotgun sequence.	GCF0022636451	NZNMRS010000101	602901	619728	16827
Pseudomonas aeruginosa strain NCTC7244, whole genome shotgun sequence.	GCF9004552951	NZUGUN010000021	121532	150485	28953
Pseudomonas aeruginosa strain PA19 contig_321_52, whole genome shotgun sequence.	GCF0028357251	NZPHST010000101	4629	63229	58600
Pseudomonas aeruginosa strain BTP035 MC15175121, whole genome shotgun sequence.	GCF0010867451	NZLFMS010000151	1043336	1078407	35071
Pseudomonas aeruginosa strain TNCF_68 NODE_10_length_179603_cov_13.0326_ID_19, whole genome shotgun sequence.	GCF0017657251	NZMAZP010000231	120363	167514	47151
Pseudomonas aeruginosa strain PASGNDM699 chromosome, complete genome.	GCF0021045951	NZCP0207041	2532749	2592934	60185
Pseudomonas aeruginosa strain PA-VAP-1 chromosome	GCF0043470051	NZCP0283321	4719186	4734442	15256
Pseudomonas aeruginosa strain Liverpool Epidemic Strain, whole genome shotgun sequence.	GCF0008239851	NZCCOH010000031	1472	87326	85854
Pseudomonas aeruginosa PA45 contig00030, whole genome shotgun sequence.	GCF0003595651	NZAPMD010000301	299007	334223	35216
Pseudomonas aeruginosa strain PA193 NODE_3_length_620854_cov_18.517145, whole genome shotgun sequence	GCF0097273351	NZWOAM010000031	472397	482719	10322
Pseudomonas aeruginosa BWH054 adTyv-supercont1.1, whole genome shotgun sequence.	GCF0006295051	NZKK2132231	1894530	1966405	71875
Pseudomonas aeruginosa strain A13 IPC691_3.1, whole genome shotgun sequence	GCF0038370451	NZNSUW010000031	282448	328966	46518
Pseudomonas aeruginosa strain AZPAE14893 AZPAE14893_contig_42, whole genome shotgun sequence.	GCF0007909051	NZJTSV010000421	202477	267377	64900
Pseudomonas aeruginosa PAK genomic scaffold acUKM-supercont-complete, whole genome shotgun sequence.	GCF0004088651	NZKE1373231	2703092	2720656	17564
Pseudomonas aeruginosa Z61 adkgo-supercont1.1, whole genome shotgun sequence.	GCF0005202151	NZKI9144561	2541589	2578251	36662
Pseudomonas aeruginosa X24509 genomic scaffold adgeH-supercont1.1, whole genome shotgun sequence.	GCF0004818651	NZKI5192661	1723135	1728346	5211
Pseudomonas aeruginosa strain AR_0457 AR_457.contig.0_1, whole genome shotgun sequence.	GCF0033242751	NZQMGP010000011	1914432	1949503	35071
Pseudomonas aeruginosa strain AUS119 IPC364_3.1, whole genome shotgun sequence	GCF0038392551	NZNSXN010000031	42249	72640	30391
Pseudomonas aeruginosa strain HUM-319-D2 PA2_C5_NODE_7_length_99101_cov_35.3366_ID_13, whole genome shotgun sequence	GCF0036328151	NZRAAT010002791	4634	65813	61179
Pseudomonas aeruginosa, whole genome shotgun sequence.	GCF0010287451	NZCGFY010000171	80327	139380	59053
Pseudomonas aeruginosa strain SP2230 chromosome, complete genome	GCF0039522851	NZCP0344341	1559920	1574878	14958
Pseudomonas aeruginosa strain HUM-269 PA3_E5_NODE_12_length_185589_cov_41.3449_ID_23, whole genome shotgun sequence	GCF0036328251	NZRAAO010000151	4631	65810	61179
Pseudomonas aeruginosa strain TUEPA7472 scaffold3_size1366156, whole genome shotgun sequence.	GCF0033245551	NZQOLE010000031	1003004	1015847	12843
Pseudomonas aeruginosa isolate 244, whole genome shotgun sequence.	GCF9001457951	NZFRNE010000511	134500	155962	21462
Pseudomonas aeruginosa strain AUS523 IPC331_22.1, whole genome shotgun sequence	GCF0039765851	NZRXEX010000221	35292	68780	33488
Pseudomonas aeruginosa strain TNCF_14 NODE_10_length_179643_cov_17.2108_ID_19, whole genome shotgun sequence.	GCF0017655851	NZMAZH010000261	120403	167553	47150
Pseudomonas aeruginosa strain Ocean-1155 chromosome, complete genome.	GCF0022374051	NZCP0225261	728883	762461	33578
Pseudomonas aeruginosa strain AUS275 IPC260_2.1, whole genome shotgun sequence	GCF0038398251	NZNSYZ010000021	515960	530226	14266
Pseudomonas aeruginosa isolate 215, whole genome shotgun sequence.	GCF9001455751	NZFRMI010000021	224651	246279	21628
Pseudomonas aeruginosa strain WH-SGI-V-07233 WH-SGI-V-07233_contig1, whole genome shotgun sequence.	GCF0014507151	NZLLNE010000011	275346	291514	16168
Pseudomonas aeruginosa BL01 genomic scaffold adgeu-supercont1.1, whole genome shotgun sequence.	GCF0004811251	NZKI5189551	2419033	2448253	29220
Pseudomonas aeruginosa X13273 genomic scaffold adgeE-supercont1.1, whole genome shotgun sequence.	GCF0004817051	NZKI5191921	1551317	1558281	6964
Pseudomonas aeruginosa strain HCF55 IPC1407_2.1, whole genome shotgun sequence	GCF0039740851	NZRXAM010000021	303318	319647	16329
Pseudomonas aeruginosa strain AZPAE13856 AZPAE13856_contig_27, whole genome shotgun sequence.	GCF0007954851	NZJTZL010000271	43757	109789	66032
Pseudomonas aeruginosa strain WH-SGI-V-07287 WH_SGI_V_07287_1, whole genome shotgun sequence.	GCF0014546751	NZLLUM010000011	487757	501687	13930
Pseudomonas aeruginosa strain PA12117 PA12117_1_3.3M, whole genome shotgun sequence.	GCF0018065051	NZLVXB010000011	2473839	2526592	52753
Pseudomonas aeruginosa strain PAC79A IPC128_1.1, whole genome shotgun sequence	GCF0043738851	NZRWSX010000011	1685553	1701168	15615
Pseudomonas aeruginosa isolate 327, whole genome shotgun sequence.	GCF9001465651	NZFRQC010000511	7798	66841	59043
Pseudomonas aeruginosa strain TC4411 Tc4411_S110_R1_001__paired__contig_23, whole genome shotgun sequence	GCF0080338051	NZVFEZ010000231	242153	255841	13688
Pseudomonas aeruginosa strain WH-SGI-V-07505 WH-SGI-V-07505_contig9, whole genome shotgun sequence.	GCF0014518951	NZLLQL010000741	108455	167500	59045
Pseudomonas aeruginosa strain AZPAE15022 AZPAE15022_contig_10, whole genome shotgun sequence.	GCF0007931051	NZJTNY010000101	85651	107547	21896
Pseudomonas aeruginosa strain NCTC10299, whole genome shotgun sequence	GCF9014825051	NZCABEES0100000451	174177	209027	34850
Pseudomonas aeruginosa PAO1 contig00454, whole genome shotgun sequence	GCF0004142751	NZASJY010004451	0	18337	18337
Pseudomonas aeruginosa strain MRSN1344 MRSN1344_contig00002, whole genome shotgun sequence	GCF0039699851	NZRXWG010000021	24507	34828	10321
Pseudomonas aeruginosa isolate 237, whole genome shotgun sequence.	GCF9001457451	NZFRMY010000071	249366	264981	15615
Pseudomonas aeruginosa strain AUS485 IPC436_2.1, whole genome shotgun sequence	GCF0038406551	NZNSWZ010000021	575620	612309	36689
Pseudomonas aeruginosa isolate PSA-6, whole genome shotgun sequence	GCF9001062351	NZFNMA010000221	346703	372352	25649
Pseudomonas aeruginosa strain WH-SGI-V-07407 WH-SGI-V-07407_contig1, whole genome shotgun sequence.	GCF0014511451	NZLLOU010000011	476320	496121	19801
Pseudomonas aeruginosa strain PABL091 NODE_15_length_99203_cov_80.7894, whole genome shotgun sequence	GCF0034123651	NZQVBF010000151	39298	49790	10492
Pseudomonas aeruginosa strain AUS301 IPC279_2.1, whole genome shotgun sequence	GCF0038407851	NZNSYR010000021	471960	487842	15882
Pseudomonas aeruginosa isolate 370, whole genome shotgun sequence.	GCF9001469651	NZFRRR010000291	393913	498430	104517
Pseudomonas aeruginosa strain PAC80A IPC167_1.1, whole genome shotgun sequence	GCF0043731751	NZRWRN010000011	421865	456371	34506
Pseudomonas aeruginosa strain PASGNDM583 PASGNDM583_contig_18, whole genome shotgun sequence.	GCF0021348351	NZNDFS010000281	55930	116115	60185
Pseudomonas aeruginosa isolate 340, whole genome shotgun sequence.	GCF9001466851	NZFRQO010000021	7798	26910	19112
Pseudomonas aeruginosa strain 1671 1671_NODE_3_length_282871_cov_101.767, whole genome shotgun sequence	GCF0038634651	NZRRBW010000031	221483	243110	21627
Pseudomonas aeruginosa strain PAC31B IPC163_1.1, whole genome shotgun sequence	GCF0043732251	NZRWRR010000011	421865	456371	34506
Pseudomonas aeruginosa strain HJ2 IPC1374_1.1, whole genome shotgun sequence	GCF0039742951	NZRXBC010000011	368101	432993	64892
Pseudomonas aeruginosa strain AR_0111 chromosome, complete genome	GCF0035718051	NZCP0322571	5970449	6021231	50782
Pseudomonas aeruginosa strain AZPAE14812 AZPAE14212_contig_43_Average_coverage:_50.19, whole genome shotgun sequence.	GCF0007950651	NZJTVW010000431	52256	112441	60185
Pseudomonas aeruginosa strain PAC98D IPC171_5.1, whole genome shotgun sequence	GCF0043731351	NZRWRJ010000051	42126	76632	34506
Pseudomonas aeruginosa strain HB159 IPC1190_2.1, whole genome shotgun sequence	GCF0038354851	NZNSOO010000021	42262	104009	61747
Pseudomonas aeruginosa strain AZPAE14860 AZPAE14860_contig_42, whole genome shotgun sequence.	GCF0007900651	NZJTUC010000421	37154	103186	66032
Pseudomonas aeruginosa strain W1j NODE_41_length_64357_cov_6.48689, whole genome shotgun sequence.	GCF0023259451	NZNQYZ010000411	33615	53417	19802
Pseudomonas aeruginosa strain AU5471 NODE_1_length_738486_cov_6.61067_ID_1, whole genome shotgun sequence.	GCF0015543251	NZLRYJ010000111	486860	506571	19711
Pseudomonas aeruginosa strain 4124363474-15 IPC1500_1.1, whole genome shotgun sequence	GCF0043705351	NZRWMS010000011	1638715	1686807	48092
Pseudomonas aeruginosa strain AR_0356 chromosome, complete genome.	GCF0029687551	NZCP0271691	3781130	3792549	11419
Pseudomonas aeruginosa strain PAC61A IPC115_2.1, whole genome shotgun sequence	GCF0043742051	NZRWTK010000021	471929	493655	21726
Pseudomonas aeruginosa strain AUS265 IPC325_5.1, whole genome shotgun sequence	GCF0039768451	NZRXEY010000051	216070	220478	4408
Pseudomonas aeruginosa BWHPSA011 genomic scaffold adgfg-supercont1.1, whole genome shotgun sequence.	GCF0004814851	NZKI5190841	1430209	1477092	46883
Pseudomonas aeruginosa strain Y31 chromosome, complete genome.	GCF0033697751	NZCP0309101	3387162	3417993	30831
Pseudomonas aeruginosa strain DLL7525 NODE5, whole genome shotgun sequence.	GCF0033129351	NZPPSO010000051	42935	58008	15073
Pseudomonas aeruginosa strain AZPAE15061 AZPAE15061_contig_68, whole genome shotgun sequence.	GCF0007932951	NZJTML010000681	5782	50024	44242
Pseudomonas aeruginosa strain MRSN26263 MRSN26263B_contig00004, whole genome shotgun sequence	GCF0039696151	NZRXUL010000041	237408	295747	58339
Pseudomonas aeruginosa isolate 166, whole genome shotgun sequence.	GCF9001450951	NZFRKI010000481	7789	57947	50158
Pseudomonas aeruginosa strain PA-W18 IPC11_1.1, whole genome shotgun sequence	GCF0038416451	NZNTAT010000011	446741	479906	33165
Pseudomonas aeruginosa strain HUM-246 PA3_B3_NODE_36_length_69715_cov_30.0997_ID_71, whole genome shotgun sequence	GCF0036324151	NZQZYH010000561	4637	30285	25648
Pseudomonas aeruginosa strain HUM-275-D1 NODE_4_length_251328_cov_23.9351_ID_7, whole genome shotgun sequence	GCF0036328451	NZRAAN010002511	38228	93560	55332
Pseudomonas aeruginosa strain AU17965 NODE_1_length_866725_cov_5.6347_ID_1, whole genome shotgun sequence.	GCF0015554551	NZLSAH010000111	299651	353586	53935
Pseudomonas aeruginosa strain 6097.1 IPC1345_1.1, whole genome shotgun sequence	GCF0043708351	NZRWNR010000011	313516	333577	20061
Pseudomonas aeruginosa strain MRSN7014 MRSN7014_contig00001, whole genome shotgun sequence	GCF0039681151	NZRXTH010000011	434172	444652	10480
Pseudomonas aeruginosa strain env408 NODE_2_length_396730_cov_22.4183, whole genome shotgun sequence.	GCF0023305051	NZNRFQ010000021	219294	239095	19801
Pseudomonas aeruginosa strain 201s070911bsl_PA2 IPC51_1.1, whole genome shotgun sequence	GCF0043751651	NZRWUL010000011	42272	62330	20058
Pseudomonas aeruginosa isolate 288, whole genome shotgun sequence.	GCF9001461751	NZFROQ010000101	7777	66822	59045
Pseudomonas aeruginosa PS75 adTyT-supercont1.1, whole genome shotgun sequence.	GCF0006293651	NZKK2131601	1681458	1697333	15875
Pseudomonas aeruginosa strain PB368 chromosome, complete genome.	GCF0028128451	NZCP0250501	2548246	2575059	26813
Pseudomonas aeruginosa strain LiA18_2003 IPC786_1.1, whole genome shotgun sequence	GCF0038364051	NZNSTG010000011	396402	429567	33165
Pseudomonas aeruginosa PAO1 isolate 2017-A CEC20_3, whole genome shotgun sequence	GCF0039571051	NZQZFW010000031	476161	489849	13688
Pseudomonas aeruginosa strain AMT0071-76 IPC573_1.1, whole genome shotgun sequence	GCF0038403051	NZNSVK010000011	347175	372823	25648
Pseudomonas aeruginosa strain CPHL5083 IPC730_4.1, whole genome shotgun sequence	GCF0038367251	NZNSUA010000041	433384	443619	10235
Pseudomonas aeruginosa isolate 223, whole genome shotgun sequence.	GCF9001456551	NZFRMR010000551	35044	48260	13216
Pseudomonas aeruginosa isolate paerg004 genome assembly, chromosome: 0	GCF9006182651	NZLR1305311	6123594	6162613	39019
Pseudomonas aeruginosa strain S1983 IPC908_3.1, whole genome shotgun sequence	GCF0038581551	NZNSSG010000031	86701	135930	49229
Pseudomonas aeruginosa genome assembly 252_12_5Pc_1_1_contgs_500, contig NODE_18_length_149523_cov_34.3929_ID_35, whole genome shotgun sequence.	GCF0013748751	NZCTDO010000181	78411	98212	19801
Pseudomonas aeruginosa isolate 201, whole genome shotgun sequence.	GCF9001454351	NZFRLS010000231	35044	48260	13216
Pseudomonas aeruginosa strain PA_4823 NODE_7_length_312002_cov_8.13534, whole genome shotgun sequence	GCF0035850551	NZLSQH010000611	61635	84239	22604
Pseudomonas aeruginosa strain HUM-279 PA3_F6_NODE_21_length_104084_cov_38.7145_ID_41, whole genome shotgun sequence	GCF0036317551	NZRAAH010000591	28619	89798	61179
Pseudomonas aeruginosa strain MSH3 IPC1178_2.1, whole genome shotgun sequence	GCF0039750251	NZRXCA010000021	533647	552015	18368
Pseudomonas aeruginosa strain Liverpool Epidemic Strain, whole genome shotgun sequence.	GCF0008246651	NZCCOX010000031	37886	123916	86030
Pseudomonas aeruginosa strain PA206 NODE_1_length_1093611_cov_24.569292, whole genome shotgun sequence	GCF0097272451	NZWOAJ010000011	546837	582297	35460
Pseudomonas aeruginosa strain Environ_2 chromosome	GCF0098001651	NZCP0470701	3079784	3099320	19536
Pseudomonas aeruginosa strain AR_0443 chromosome.	GCF0030741151	NZCP0291471	6047818	6107529	59711
Pseudomonas aeruginosa strain AUS343 IPC274_1.1, whole genome shotgun sequence	GCF0038408851	NZNSYU010000011	1408574	1458381	49807
Pseudomonas aeruginosa strain 272S250511BSL_PA1 IPC57_1.1, whole genome shotgun sequence	GCF0043744251	NZRWUH010000011	349486	375134	25648
Pseudomonas aeruginosa BL12 genomic scaffold adgfc-supercont1.1, whole genome shotgun sequence.	GCF0004809051	NZKI5188561	1607955	1642230	34275
Pseudomonas aeruginosa strain AZPAE14880 AZPAE14880_contig_3, whole genome shotgun sequence.	GCF0007905451	NZJTTI010000031	174530	188393	13863
Pseudomonas aeruginosa genome assembly 265_12_5Pc_8_contgs_500, contig NODE_1_length_751829_cov_24.1739_ID_1, whole genome shotgun sequence.	GCF0013750951	NZCUXR010000241	30615	45845	15230
Pseudomonas aeruginosa genome assembly 265_12_5Pc_8_contgs_500, contig NODE_18_length_149571_cov_23.792_ID_35, whole genome shotgun sequence.	GCF0013750951	NZCUXR010000421	78411	98212	19801
Pseudomonas aeruginosa BWHPSA009 genomic scaffold adggc-supercont1.1, whole genome shotgun sequence.	GCF0004815251	NZKI5191161	2344072	2398990	54918
Pseudomonas aeruginosa CF614 genomic scaffold adggb-supercont1.1, whole genome shotgun sequence.	GCF0004803551	NZKI5186561	531603	594453	62850
Pseudomonas aeruginosa isolate 348, whole genome shotgun sequence.	GCF9001467651	NZFRQV010000041	271953	297601	25648
Pseudomonas aeruginosa strain AZPAE14840 AZPAE14840_contig_6, whole genome shotgun sequence.	GCF0007895551	NZJTUU010000061	313043	338337	25294
Pseudomonas aeruginosa strain FDAARGOS_767 chromosome, complete genome	GCF0063647351	NZCP0410081	3287911	3307446	19535
Pseudomonas aeruginosa strain FDAARGOS_121 unitig_0_quiver_pilon, whole genome shotgun sequence.	GCF0014714351	NZLORX020000031	5360067	5400976	40909
Pseudomonas aeruginosa strain 8 IPC1590_14.1, whole genome shotgun sequence	GCF0043700951	NZRWLN010000141	17593	31806	14213
Pseudomonas aeruginosa strain AR445 chromosome, complete genome.	GCF0030737351	NZCP0290881	2646681	2693323	46642
Pseudomonas aeruginosa strain 5998 IPC1321_3.1, whole genome shotgun sequence	GCF0043716651	NZRWOO010000031	470316	486098	15782
Pseudomonas aeruginosa strain TNCF_105 NODE_3_length_396723_cov_21.5754_ID_5, whole genome shotgun sequence.	GCF0017658551	NZMAZV010000241	50326	97479	47153
Pseudomonas aeruginosa strain U1o-2 NODE_18_length_150848_cov_35.8866, whole genome shotgun sequence.	GCF0023260451	NZNQZF010000181	120117	139918	19801
Pseudomonas aeruginosa strain M8A1 genome.	GCF0021169451	NZCP0156471	2386408	2408068	21660
Pseudomonas aeruginosa strain AUS263 IPC453_2.1, whole genome shotgun sequence	GCF0038404551	NZNSWS010000021	529378	546502	17124
Pseudomonas aeruginosa BWHPSA002 genomic scaffold adgeG-supercont1.1, whole genome shotgun sequence.	GCF0004816651	NZKI5191731	1815404	1819304	3900
Pseudomonas aeruginosa strain PAC115A IPC159_2.1, whole genome shotgun sequence	GCF0043732551	NZRWRU010000021	301488	355427	53939
Pseudomonas aeruginosa strain HIAE_PA14 1c, whole genome shotgun sequence.	GCF0030555051	NZQBEI010000011	1329818	1361759	31941
Pseudomonas aeruginosa strain P1885 IPC1150_9.1, whole genome shotgun sequence	GCF0039750851	NZRXCC010000091	53034	63811	10777
Pseudomonas aeruginosa strain AUS227 IPC253_3.1, whole genome shotgun sequence	GCF0039766551	NZRXFD010000031	60663	88984	28321
Pseudomonas aeruginosa isolate 227, whole genome shotgun sequence.	GCF9001456951	NZFRMT010000491	4503	25965	21462
Pseudomonas aeruginosa strain PA-W1 IPC1280_7.1, whole genome shotgun sequence	GCF0038336851	NZNSNT010000071	17595	27892	10297
Pseudomonas aeruginosa strain WH-SGI-V-07305 WH_SGI_V_07305_3, whole genome shotgun sequence.	GCF0014547251	NZLLUW010000231	577435	625527	48092
Pseudomonas aeruginosa strain VET-31 NODE_25_length_98554_cov_24.0553_ID_49, whole genome shotgun sequence	GCF0036329651	NZQZZO010000811	5784	58791	53007
Pseudomonas aeruginosa strain HCF73 IPC1422_5.1, whole genome shotgun sequence	GCF0039739251	NZRXAC010000051	182498	247390	64892
Pseudomonas aeruginosa strain GIMC5015:PAKB6, complete sequence	GCF0039578251	NZCP0344291	2415519	2429207	13688
Pseudomonas aeruginosa strain AR442 chromosome, complete genome.	GCF0030737951	NZCP0290901	1650424	1709470	59046
Pseudomonas aeruginosa strain Liverpool Epidemic Strain, whole genome shotgun sequence.	GCF0008245451	NZCCOC010000031	37741	121242	83501
Pseudomonas aeruginosa strain delta6_6 chromosome	GCF0098000651	NZCP0470651	3079835	3099370	19535
Pseudomonas aeruginosa strain HCF100 IPC1409_1.1, whole genome shotgun sequence	GCF0039745751	NZRXAK010000011	675906	691788	15882
Pseudomonas aeruginosa strain env159a NODE_11_length_195867_cov_15.9886, whole genome shotgun sequence.	GCF0023264551	NZNRAI010000111	116298	142491	26193
Pseudomonas aeruginosa strain MRSN1688 MRSN1688_contig00002, whole genome shotgun sequence	GCF0039693151	NZRXVM010000021	285820	340243	54423
Pseudomonas aeruginosa strain PABL105 NODE_17_length_135558_cov_55.2492, whole genome shotgun sequence	GCF0034104451	NZQVAS010000171	39283	87375	48092
Pseudomonas aeruginosa strain CCBH4850 scaffold14.1, whole genome shotgun sequence	GCF0041528551	NZSEMF010000141	44010	102610	58600
Pseudomonas aeruginosa strain AUS496 IPC441_3.1, whole genome shotgun sequence	GCF0038389251	NZNSWW010000031	64030	92811	28781
Pseudomonas aeruginosa genome assembly 202_Tsb_8_contgs_500, contig NODE_18_length_149523_cov_29.3957_ID_35, whole genome shotgun sequence.	GCF0013753551	NZCTCK010000171	78411	98212	19801
Pseudomonas aeruginosa genome assembly 202_Tsb_8_contgs_500, contig NODE_19_length_125434_cov_24.7443_ID_37, whole genome shotgun sequence.	GCF0013753551	NZCTCK010000411	1737	22170	20433
Pseudomonas aeruginosa strain PAC106A IPC130_2.1, whole genome shotgun sequence	GCF0043740051	NZRWSV010000021	342949	364411	21462
Pseudomonas aeruginosa isolate 342, whole genome shotgun sequence.	GCF9001467051	NZFRQP010000131	135107	154908	19801
Pseudomonas aeruginosa 3576 adVri-supercont1.1, whole genome shotgun sequence.	GCF0006292651	NZKK2128141	474509	521660	47151
Pseudomonas aeruginosa strain Tu863 IPC884_15.1, whole genome shotgun sequence	GCF0038371951	NZNSSP010000151	42034	66687	24653
Pseudomonas aeruginosa strain NCTC8058, whole genome shotgun sequence.	GCF9004555551	NZUGUO010000011	2533866	2563226	29360
Pseudomonas aeruginosa strain AZPAE14819 AZPAE14819_contig_8, whole genome shotgun sequence.	GCF0007952051	NZJTVP010000081	116402	175051	58649
Pseudomonas aeruginosa strain ATCC BAA-2109 IPC1577_8.1, whole genome shotgun sequence.	GCF0022369851	NZMVGW010000081	153653	182104	28451
Pseudomonas aeruginosa strain EC22 isolate AUS52 IPC1258_2.1, whole genome shotgun sequence	GCF0036988551	NZMCMK010000021	477736	507619	29883
Pseudomonas aeruginosa strain 5992 IPC1315_3.1, whole genome shotgun sequence	GCF0043717751	NZRWOU010000031	470315	486097	15782
Pseudomonas aeruginosa isolate 161.1, whole genome shotgun sequence.	GCF9001477951	NZFRUU010000781	181491	207139	25648
Pseudomonas aeruginosa isolate 213, whole genome shotgun sequence.	GCF9001455551	NZFRMF010000221	224658	246286	21628
Pseudomonas aeruginosa isolate 345, whole genome shotgun sequence.	GCF9001467351	NZFRQS010000131	346626	372274	25648
Pseudomonas aeruginosa BWHPSA022 genomic scaffold adgeq-supercont1.1, whole genome shotgun sequence.	GCF0004812651	NZKI5190171	2497020	2544316	47296
Pseudomonas aeruginosa strain BTP031 MC15175028, whole genome shotgun sequence.	GCF0010866551	NZLFMO010000071	2621748	2650972	29224
Pseudomonas aeruginosa strain AR_0440 chromosome.	GCF0030740951	NZCP0291481	1622642	1637600	14958
Pseudomonas aeruginosa strain PAC54A IPC111_2.1, whole genome shotgun sequence	GCF0043741751	NZRWTO010000021	555328	598936	43608
Pseudomonas aeruginosa BWHPSA004 genomic scaffold adgfZ-supercont1.1, whole genome shotgun sequence.	GCF0004816251	NZKI5191571	1693865	1709650	15785
Pseudomonas aeruginosa strain 982 IPC99_1.1, whole genome shotgun sequence	GCF0038401651	NZNTAB010000011	470903	488837	17934
Pseudomonas aeruginosa S35004 genomic scaffold adgfR-supercont1.2, whole genome shotgun sequence.	GCF0004817251	NZKI5192081	2893526	2897426	3900
Pseudomonas aeruginosa strain MRSN18754 MRSN18754A_contig00016, whole genome shotgun sequence	GCF0039686251	NZRXVH010000161	107339	127685	20346
Pseudomonas aeruginosa strain WH-SGI-V-07058 WH-SGI-V-07058_contig1, whole genome shotgun sequence.	GCF0014491551	NZLLKY010000011	480381	482931	2550
Pseudomonas aeruginosa strain FDAARGOS_571 chromosome, complete genome	GCF0038128851	NZCP0338331	5785799	5815023	29224
Pseudomonas aeruginosa strain env105 NODE_8_length_219209_cov_9.61392, whole genome shotgun sequence.	GCF0023320951	NZNRGK010000081	53823	78532	24709
Pseudomonas aeruginosa strain AZPAE15013 AZPAE15013_contig_16, whole genome shotgun sequence.	GCF0007929251	NZJTOH010000161	39286	76004	36718
Pseudomonas aeruginosa strain AZPAE14959 AZPAE14959_contig_9, whole genome shotgun sequence.	GCF0007917351	NZJTQI010000091	122690	183850	61160
Pseudomonas aeruginosa strain BTP036 MC15175126, whole genome shotgun sequence.	GCF0010868051	NZLFMT010000011	3905157	3940228	35071
Pseudomonas aeruginosa strain Jp54 IPC747_1.1, whole genome shotgun sequence	GCF0038365651	NZNSTQ010000011	684554	749831	65277
Pseudomonas aeruginosa strain L3 L3_L1.R1.clean_(paired)_contig_18, whole genome shotgun sequence	GCF0086326751	NZVWQQ010000181	339428	368239	28811
Pseudomonas aeruginosa isolate 111, whole genome shotgun sequence.	GCF9001445451	NZFRIK010000451	7796	37959	30163
Pseudomonas aeruginosa strain PA-W27 IPC17_8.1, whole genome shotgun sequence	GCF0038416051	NZNTAN010000081	274344	299955	25611
Pseudomonas aeruginosa strain UM1046 NODE_17_length_90561_cov_3.172900, whole genome shotgun sequence	GCF0093919051	NZWHVN010000171	42089	75254	33165
Pseudomonas aeruginosa SCV20265, complete genome.	GCF0005103051	NC0231491	2592183	2611924	19741
Pseudomonas aeruginosa strain PAER4_119, complete genome.	GCF0018795251	NZCP0131131	2416042	2438221	22179
Pseudomonas aeruginosa strain L33 L33_L1.R1.clean_(paired)_contig_11, whole genome shotgun sequence	GCF0086297951	NZVWQD010000111	596023	614539	18516
Pseudomonas aeruginosa strain TNCF_101 NODE_6_length_176644_cov_19.5249_ID_11, whole genome shotgun sequence.	GCF0017658351	NZMAZU010000381	83354	130505	47151
Pseudomonas aeruginosa strain MRSN16744 MRSN16744_contig00002, whole genome shotgun sequence	GCF0039692951	NZRXVO010000021	273883	288956	15073
Pseudomonas aeruginosa strain WH-SGI-V-07507 WH-SGI-V-07507_contig1, whole genome shotgun sequence.	GCF0014532851	NZLLQN010000011	263078	288727	25649
Pseudomonas sp. AK6U chromosome, complete genome	GCF0028432851	NZCP0252291	2384875	2449765	64890
Pseudomonas aeruginosa strain Bo559 IPC867_6.1, whole genome shotgun sequence	GCF0038373351	NZNSSW010000061	138064	156638	18574
Pseudomonas aeruginosa genome assembly 224_Rw192_contgs_500, contig NODE_18_length_149508_cov_26.2507_ID_35, whole genome shotgun sequence.	GCF0013746751	NZCTCW010000311	78411	98212	19801
Pseudomonas aeruginosa strain env051b NODE_4_length_269166_cov_9.29664, whole genome shotgun sequence.	GCF0023321651	NZNRGM010000041	122490	149808	27318
Pseudomonas aeruginosa genome assembly 243_15_121C_contgs_500, contig NODE_17_length_149509_cov_22.7757_ID_33, whole genome shotgun sequence.	GCF0013738151	NZCUXI010000301	78411	98212	19801
Pseudomonas aeruginosa strain Cotonu1 IPC875_1.1, whole genome shotgun sequence	GCF0038362451	NZNSSV010000011	631621	650195	18574
Pseudomonas aeruginosa strain TNCF_176 NODE_1_length_599883_cov_26.0199_ID_1, whole genome shotgun sequence.	GCF0017661351	NZMBMR010000151	118622	165774	47152
Pseudomonas aeruginosa isolate 154, whole genome shotgun sequence.	GCF9001449751	NZFRJP010000951	101816	127464	25648
Pseudomonas aeruginosa strain S434_C09_BS S434_C09_BS_NODE_13_length_172554, whole genome shotgun sequence.	GCF0021360651	NZNFGH010000131	113095	132808	19713
Pseudomonas aeruginosa strain AZPAE14916 AZPAE14916_contig_9, whole genome shotgun sequence.	GCF0007940051	NZJTRZ010000091	118143	155321	37178
Pseudomonas aeruginosa strain AZPAE14700 AZPAE14700_contig_35, whole genome shotgun sequence.	GCF0007947351	NZJTXF010000351	199934	209161	9227
Pseudomonas aeruginosa strain ENV-205 PA2_G1_NODE_26_length_69027_cov_24.0304_ID_51, whole genome shotgun sequence	GCF0036322351	NZQZYS010000851	2791	18573	15782
Pseudomonas aeruginosa strain SF2, whole genome shotgun sequence	GCF0078602651	NZSZXO010000011	346576	372225	25649
Pseudomonas aeruginosa strain M10 NODE_26_length_94449_cov_19.8402, whole genome shotgun sequence	GCF0041235351	NZSDVO010000251	39344	53032	13688
Pseudomonas aeruginosa isolate PA14Or_reads genome assembly, chromosome: PA14OR.	GCF9000958051	NZLT6083301	2474124	2493925	19801
Pseudomonas aeruginosa isolate 338, whole genome shotgun sequence.	GCF9001466651	NZFRQM010000611	7796	27597	19801
Pseudomonas aeruginosa strain env159b NODE_11_length_194890_cov_15.8484, whole genome shotgun sequence.	GCF0023266851	NZNRAH010000111	116303	142496	26193
Pseudomonas aeruginosa strain VET-78 NODE_14_length_138274_cov_39.4113_ID_27, whole genome shotgun sequence	GCF0036302851	NZRADG010001131	75228	88538	13310
Pseudomonas aeruginosa strain UQCCR 462667354 AA24 NODE_3_length_131099_cov_36.6048, whole genome shotgun sequence.	GCF0020881652	NZMWZG020002861	62839	91290	28451
Pseudomonas aeruginosa strain env084 NODE_7_length_335966_cov_8.63692, whole genome shotgun sequence.	GCF0023309551	NZNRBN010000071	276133	308565	32432
Pseudomonas aeruginosa strain PA-W26 IPC16_8.1, whole genome shotgun sequence	GCF0038416151	NZNTAO010000081	274344	299955	25611
Pseudomonas aeruginosa strain PAC79B IPC129_1.1, whole genome shotgun sequence	GCF0043739151	NZRWSW010000011	333428	354890	21462
Pseudomonas aeruginosa strain WH-SGI-V-07377 WH-SGI-V-07377_contig1, whole genome shotgun sequence.	GCF0014502451	NZLLOB010000011	384224	408583	24359
Pseudomonas aeruginosa 3577 adTvG-supercont1.1, whole genome shotgun sequence.	GCF0006292451	NZKK2127571	379867	390188	10321
Pseudomonas aeruginosa strain UMB6995 NODE_21_length_73814_cov_6.211679, whole genome shotgun sequence	GCF0098072651	NZWUDE010000211	6543	60482	53939
Pseudomonas aeruginosa strain WH-SGI-V-07265 WH_SGI_V_07265_3, whole genome shotgun sequence.	GCF0014529951	NZLLTW010000231	350372	365667	15295
Pseudomonas aeruginosa isolate paerg003 genome assembly, chromosome: 0	GCF9006182751	NZLR1305301	2371962	2410985	39023
Pseudomonas aeruginosa strain Pae112 NODE_13_length_216428_cov_20.5018, whole genome shotgun sequence.	GCF0022163251	NZNKXY010000131	78522	97034	18512
Pseudomonas aeruginosa genome assembly 210_Rw11_contgs_500, contig NODE_7_length_271150_cov_28.2701_ID_13, whole genome shotgun sequence.	GCF0013744351	NZCUWY010000421	104461	121240	16779
Pseudomonas aeruginosa genome assembly 210_Rw11_contgs_500, contig NODE_16_length_149523_cov_29.8281_ID_31, whole genome shotgun sequence.	GCF0013744351	NZCUWY010000371	78411	98212	19801
Pseudomonas aeruginosa strain AUS077 IPC347_1.1, whole genome shotgun sequence	GCF0038392851	NZNSXU010000011	87509	107570	20061
Pseudomonas aeruginosa isolate 127.1, whole genome shotgun sequence.	GCF9001477151	NZFRUM010000921	7798	38612	30814
Pseudomonas aeruginosa strain TNCF_133 NODE_7_length_221632_cov_10.1788_ID_13, whole genome shotgun sequence.	GCF0017655451	NZMAZF010000211	33900	81052	47152
Pseudomonas aeruginosa strain PAN3 scaffold_2, whole genome shotgun sequence	GCF0022635351	NZNMQQ010000031	516504	569257	52753
Pseudomonas aeruginosa strain WH-SGI-V-07635 WH-SGI-V-07635_contig11, whole genome shotgun sequence.	GCF0014521351	NZLLRG010000101	30181	82934	52753
Pseudomonas aeruginosa strain HUM-13 NODE_12_length_143569_cov_16.3831_ID_23, whole genome shotgun sequence	GCF0036320251	NZQZZQ010000691	38205	93519	55314
Pseudomonas aeruginosa strain PPF-18 scaffold_1, whole genome shotgun sequence.	GCF0023126751	NZMWYE010000021	125342	132215	6873
Pseudomonas aeruginosa strain WH-SGI-V-07282 WH-SGI-V-07282_contig1, whole genome shotgun sequence.	GCF0014530751	NZLLUI010000011	318289	339917	21628
Pseudomonas aeruginosa strain AZPAE14861 AZPAE14861_contig_17, whole genome shotgun sequence.	GCF0007900851	NZJTUB010000171	54961	70576	15615
Pseudomonas aeruginosa strain PASGNDM590 PASGNDM590_contig_28, whole genome shotgun sequence.	GCF0021349751	NZNDFU010000321	55930	116115	60185
Pseudomonas aeruginosa BL07 genomic scaffold adgfo-supercont1.1, whole genome shotgun sequence.	GCF0004810051	NZKI5189061	2133177	2209893	76716
Pseudomonas aeruginosa strain 286S270711BSL_PA1 IPC61_1.1, whole genome shotgun sequence	GCF0043747051	NZRWUD010000011	166162	229011	62849
Pseudomonas aeruginosa strain PRD-10 chromosome	GCF0051543251	NZCP0397491	1795590	1811041	15451
Pseudomonas aeruginosa strain ST773 chromosome, complete genome	GCF0096641651	NZCP0419451	2553829	2600342	46513
Pseudomonas aeruginosa genome assembly 215_2_5Pc_8_contgs_500, contig NODE_13_length_184058_cov_32.2341_ID_25, whole genome shotgun sequence.	GCF0013744951	NZCUXB010000301	104218	113965	9747
Pseudomonas aeruginosa genome assembly 215_2_5Pc_8_contgs_500, contig NODE_18_length_149523_cov_32.0056_ID_35, whole genome shotgun sequence.	GCF0013744951	NZCUXB010000521	78411	98212	19801
Pseudomonas aeruginosa strain WH-SGI-V-07060 WH-SGI-V-07060_contig1, whole genome shotgun sequence.	GCF0014491451	NZLLKV010000011	282386	328904	46518
Pseudomonas aeruginosa strain A681 chromosome, complete genome	GCF0075590851	NZCP0417711	2545879	2577977	32098
Pseudomonas aeruginosa genome assembly 242_15Pc_5_contgs_500, contig NODE_17_length_149508_cov_25.3811_ID_33, whole genome shotgun sequence.	GCF0013737951	NZCTDJ010000501	78411	98212	19801
Pseudomonas aeruginosa strain WH-SGI-V-07412 WH-SGI-V-07412_contig7, whole genome shotgun sequence.	GCF0014513551	NZLLOZ010000511	219221	234402	15181
Pseudomonas aeruginosa 148 contig_35, whole genome shotgun sequence.	GCF0006475952	NZATAJ020000351	8357	17584	9227
Pseudomonas aeruginosa strain AZPAE15050 AZPAE15050_contig_26, whole genome shotgun sequence.	GCF0007916651	NZJTMW010000261	59102	213235	154133
Pseudomonas aeruginosa BWHPSA015 genomic scaffold adggh-supercont1.1, whole genome shotgun sequence.	GCF0004814051	NZKI5190711	1031261	1077330	46069
Pseudomonas aeruginosa isolate 225, whole genome shotgun sequence.	GCF9001456751	NZFRMQ010000441	398364	413979	15615
Pseudomonas aeruginosa isolate 386, whole genome shotgun sequence.	GCF9001471251	NZFRSG010000351	290233	311311	21078
Pseudomonas aeruginosa strain VA-134, complete genome.	GCF0014478451	NZCP0132451	6197549	6240797	43248
Pseudomonas aeruginosa strain AZPAE14845 AZPAE14845_contig_41, whole genome shotgun sequence.	GCF0007897051	NZJTUP010000411	44284	69932	25648
Pseudomonas aeruginosa strain C3128 IPC715_1.1, whole genome shotgun sequence	GCF0038376251	NZNSUI010000011	477964	526056	48092
Pseudomonas aeruginosa strain MRSN321 MRSN321_contig00002, whole genome shotgun sequence	GCF0039685851	NZRXUG010000021	484852	508169	23317
Pseudomonas aeruginosa genome assembly 293_Tsb_Bead_Dwl_Pool_2_contgs_500, contig NODE_2_length_525782_cov_28.8098_ID_3, whole genome shotgun sequence.	GCF0013743351	NZCUYG010000641	463743	477607	13864
Pseudomonas aeruginosa strain PA-W13 IPC8_2.1, whole genome shotgun sequence	GCF0038412051	NZNTAW010000021	597262	640120	42858
Pseudomonas aeruginosa strain env099 NODE_3_length_483715_cov_5.78778, whole genome shotgun sequence.	GCF0023308151	NZNRBC010000031	301710	316585	14875
Pseudomonas aeruginosa isolate PSA-5, whole genome shotgun sequence	GCF9001062151	NZFNLV010000221	346703	372352	25649
Pseudomonas aeruginosa strain WH-SGI-V-07692 WH-SGI-V-07692_contig1, whole genome shotgun sequence.	GCF0014525451	NZLLSM010000011	308024	328246	20222
Pseudomonas aeruginosa strain PA4722 OBOEIKDE_2, whole genome shotgun sequence	GCF0099017951	NZVKOE010000021	468332	521085	52753
Pseudomonas aeruginosa genome assembly 263_10Pc_3_contgs_500, contig NODE_18_length_149523_cov_18.7059_ID_35, whole genome shotgun sequence.	GCF0013750551	NZCTET010000441	78411	98212	19801
Pseudomonas aeruginosa strain AZPAE14864 AZPAE14864_contig_4, whole genome shotgun sequence.	GCF0007901551	NZJTTY010000041	25354	44519	19165
Pseudomonas aeruginosa BWHPSA007 genomic scaffold adgeP-supercont1.2, whole genome shotgun sequence.	GCF0004815651	NZKI5191401	1464118	1516870	52752
Pseudomonas aeruginosa strain M55212 contig1, whole genome shotgun sequence.	GCF0029272351	NZJPEY010000011	2596216	2678786	82570
Pseudomonas aeruginosa strain PA298 chromosome, complete genome	GCF0053050051	NZCP0401271	2499734	2552488	52754
Pseudomonas aeruginosa strain Tu61 IPC740_1.1, whole genome shotgun sequence	GCF0038366851	NZNSTT010000011	703486	712934	9448
Pseudomonas aeruginosa isolate 121, whole genome shotgun sequence.	GCF9001446351	NZFRIR010000531	39282	69445	30163
Pseudomonas aeruginosa strain 014-2A IPC1020_6.1, whole genome shotgun sequence	GCF0038356851	NZNSQX010000061	17595	27893	10298
Pseudomonas aeruginosa isolate 229, whole genome shotgun sequence.	GCF9001457151	NZFRMV010000441	7786	23401	15615
Pseudomonas aeruginosa strain TNCF_42M NODE_13_length_179639_cov_29.0146_ID_25, whole genome shotgun sequence.	GCF0017656951	NZMAZN010000181	120401	167552	47151
Pseudomonas aeruginosa strain LW chromosome, complete genome	GCF0040108951	NZCP0224781	1254830	1283728	28898
Pseudomonas aeruginosa strain AZPAE15053 AZPAE15053_contig_11, whole genome shotgun sequence.	GCF0007906251	NZJTMT010000111	113058	173382	60324
Pseudomonas aeruginosa C41 genomic scaffold adgfh-supercont1.1, whole genome shotgun sequence.	GCF0004804551	NZKI5187091	3068806	3089516	20710
Pseudomonas aeruginosa strain SCH_ABX10 ABX10_contig000003, whole genome shotgun sequence.	GCF0019902951	NZMULH010000031	84720	101548	16828
Pseudomonas aeruginosa strain EML528 contig_3, whole genome shotgun sequence.	GCF0012807551	NZLFXS010000141	155719	189676	33957
Pseudomonas aeruginosa strain NCTC10728 genome assembly, chromosome: 1	GCF9006370451	NZLR1343421	5367893	5389580	21687
Pseudomonas aeruginosa strain HUM-296 PA3_C8_NODE_13_length_173903_cov_37.2032_ID_25, whole genome shotgun sequence	GCF0036333651	NZQZXV010000361	115097	147529	32432
Pseudomonas aeruginosa strain WH-SGI-V-07410 WH-SGI-V-07410_contig1, whole genome shotgun sequence.	GCF0014513251	NZLLOX010000011	1203014	1222461	19447
Pseudomonas aeruginosa genome assembly 253_12_5Pc_7_contgs_500, contig NODE_2_length_451136_cov_28.5319_ID_3, whole genome shotgun sequence.	GCF0013748951	NZCTDQ010000381	78411	98212	19801
Pseudomonas aeruginosa isolate PSA-13, whole genome shotgun sequence	GCF9001062651	NZFNME010000221	346703	372352	25649
Pseudomonas aeruginosa strain OY15 IPC1434_1.1, whole genome shotgun sequence	GCF0039739051	NZRWZV010000011	620441	645097	24656
Pseudomonas aeruginosa strain PAC44A IPC154_2.1, whole genome shotgun sequence	GCF0043787451	NZRWRZ010000021	306094	360033	53939
Pseudomonas aeruginosa isolate 240, whole genome shotgun sequence.	GCF9001457551	NZFRMW010000561	7790	23405	15615
Pseudomonas aeruginosa HB15 contig000001, whole genome shotgun sequence.	GCF0002157954	NZAEVW030000011	304334	325007	20673
Pseudomonas aeruginosa strain WH-SGI-V-07686 WH-SGI-V-07686_contig5, whole genome shotgun sequence.	GCF0014536451	NZLLSG010000451	42155	96095	53940
Pseudomonas aeruginosa strain AR_0241 AR_241.contig.1_1, whole genome shotgun sequence.	GCF0033244051	NZQMGI010000021	2152067	2196224	44157
Pseudomonas aeruginosa strain AR_0354 chromosome, complete genome.	GCF0029685851	NZCP0271711	361047	390271	29224
Pseudomonas aeruginosa strain BJ4 IPC1423_2.1, whole genome shotgun sequence	GCF0039739151	NZRXAB010000021	542145	558019	15874
Pseudomonas aeruginosa genome assembly 258_Rw99_contgs_500, contig NODE_1_length_793506_cov_26.3396_ID_1, whole genome shotgun sequence.	GCF0013749551	NZCTDW010000451	420781	440582	19801
Pseudomonas denitrificans strain 106_PDEN 1248_116177_1439834_1004+,...,734+, whole genome shotgun sequence.	GCF0010602051	NZJWEK010002471	39203	54384	15181
Pseudomonas aeruginosa strain AMT0005-1 IPC539_2.1, whole genome shotgun sequence	GCF0038386051	NZNSVU010000021	287572	308650	21078
Pseudomonas aeruginosa strain PABL060 NODE_10_length_143459_cov_70.7999, whole genome shotgun sequence	GCF0034107451	NZQVCJ010000101	41974	103721	61747
Pseudomonas aeruginosa strain TNCF_106 NODE_16_length_142653_cov_16.432_ID_31, whole genome shotgun sequence.	GCF0017658651	NZMAZW010000291	83357	130510	47153
Pseudomonas aeruginosa M8A.4 genomic scaffold adgfJ-supercont1.1, whole genome shotgun sequence.	GCF0004805551	NZKI5187321	2436319	2463827	27508
Pseudomonas aeruginosa BWH031 adTxV-supercont1.1, whole genome shotgun sequence.	GCF0006291051	NZKK2122161	431532	479627	48095
Pseudomonas aeruginosa strain S252_C06_RS S252_C06_RS_NODE_9_length_167238, whole genome shotgun sequence.	GCF0021362151	NZNFGN010000091	113167	132877	19710
Pseudomonas aeruginosa strain PA-VAP-4 chromosome	GCF0043470451	NZCP0283681	5349914	5366009	16095
Pseudomonas aeruginosa strain 6762 chromosome	GCF0036654951	NZCP0300751	4527189	4573748	46559
Pseudomonas aeruginosa DK2 chromosome, complete genome.	GCF0002713651	NC0180801	2295622	2332119	36497
Pseudomonas aeruginosa genome assembly 247_Rw149_contgs_500, contig NODE_19_length_149508_cov_20.7909_ID_37, whole genome shotgun sequence.	GCF0013738951	NZCUXL010000211	78411	98212	19801
Pseudomonas aeruginosa isolate 283, whole genome shotgun sequence.	GCF9001461351	NZFROL010000631	98584	163476	64892
Pseudomonas aeruginosa strain DUN-015A IPC1027_3.1, whole genome shotgun sequence	GCF0038357251	NZNSQW010000031	315008	336733	21725
Pseudomonas aeruginosa strain AZPAE14903 AZPAE14903_contig_131, whole genome shotgun sequence.	GCF0007911451	NZJTSM010001311	38310	44178	5868
Pseudomonas aeruginosa strain 1653 1653_NODE_1_length_489206_cov_106.168, whole genome shotgun sequence	GCF0038635151	NZRRBR010000011	271325	325267	53942
Pseudomonas aeruginosa strain HUM-323-D1 NODE_1_length_313239_cov_35.4813_ID_1, whole genome shotgun sequence	GCF0036319851	NZQZZS010001621	246016	301348	55332
Pseudomonas aeruginosa strain PABL007 NODE_21_length_111432_cov_51.7218, whole genome shotgun sequence	GCF0034117651	NZQVED010000211	43074	71682	28608
Pseudomonas aeruginosa strain AU13212 NODE_1_length_940133_cov_7.66823_ID_1, whole genome shotgun sequence.	GCF0015545451	NZLRYQ010000111	488238	542176	53938
Pseudomonas aeruginosa strain 140 scaffold_7, whole genome shotgun sequence	GCF0043502051	NZSCXO010000081	85508	113959	28451
Pseudomonas aeruginosa strain 5987 IPC1307_1.1, whole genome shotgun sequence	GCF0043719051	NZRWPC010000011	486202	503766	17564
Pseudomonas aeruginosa strain WH-SGI-V-07691 WH-SGI-V-07691_contig3, whole genome shotgun sequence.	GCF0014536651	NZLLSL010000231	329651	343514	13863
Pseudomonas aeruginosa strain 6D92(H) isolate AMT0023-34 IPC1261_5.1, whole genome shotgun sequence	GCF0036984851	NZMCMH010000051	42124	96074	53950
Pseudomonas aeruginosa isolate paerg007, whole genome shotgun sequence	GCF9006080351	NZUWXD010000011	2368918	2383937	15019
Pseudomonas aeruginosa isolate 347, whole genome shotgun sequence.	GCF9001467551	NZFRQU010000511	346630	372278	25648
Pseudomonas aeruginosa strain CCUG 70744 chromosome, complete genome.	GCF0031942451	NZCP0232551	481360	540414	59054
Pseudomonas aeruginosa strain S435_C09_BS S435_C09_BS_NODE_6_length_311762, whole genome shotgun sequence.	GCF0021360751	NZNFGG010000061	173507	187372	13865
Pseudomonas aeruginosa BWHPSA012 genomic scaffold adgfC-supercont1.1, whole genome shotgun sequence.	GCF0004814651	NZKI5190801	2461280	2491951	30671
Pseudomonas aeruginosa strain WH-SGI-V-07272 WH_SGI_V_07272_3, whole genome shotgun sequence.	GCF0014530651	NZLLUA010000231	561724	609817	48093
Pseudomonas aeruginosa strain GIMC5001:PAT-23 chromosome	GCF0083309851	NZCP0434831	2496535	2525759	29224
Pseudomonas aeruginosa strain AZPAE14978 AZPAE14978_contig_12, whole genome shotgun sequence.	GCF0007921651	NZJTPQ010000121	113121	171826	58705
Pseudomonas aeruginosa strain WH-SGI-V-07054 WH-SGI-V-07054_contig17, whole genome shotgun sequence.	GCF0014504251	NZLLLI010000261	45296	106456	61160
Pseudomonas aeruginosa strain 14651 contig_7, whole genome shotgun sequence.	GCF0014141551	NZLKPU010000161	1503502	1507428	3926
Pseudomonas aeruginosa strain SC1 IPC1432_12.1, whole genome shotgun sequence	GCF0039738851	NZRWZX010000121	113174	123557	10383
Pseudomonas aeruginosa strain AZPAE14814 AZPAE14814_contig_14, whole genome shotgun sequence.	GCF0007951051	NZJTVU010000141	122631	181739	59108
Pseudomonas aeruginosa strain PAC33A IPC146_1.1, whole genome shotgun sequence	GCF0043734251	NZRWSH010000011	599532	643140	43608
Pseudomonas aeruginosa strain CCBH3462 scaffold_12, whole genome shotgun sequence	GCF0047858151	NZSRPM010000131	4657	63257	58600
Pseudomonas aeruginosa isolate 413, whole genome shotgun sequence.	GCF9001474051	NZFRTI010001681	99139	118850	19711
Pseudomonas aeruginosa isolate 286, whole genome shotgun sequence.	GCF9001461651	NZFROP010000421	0	64592	64592
Pseudomonas aeruginosa strain S567_C10_BS S567_C10_BS_NODE_13_length_202685, whole genome shotgun sequence.	GCF0021359651	NZNFFZ010000131	19169	78212	59043
Pseudomonas aeruginosa UDL genomic scaffold adgeV-supercont1.1, whole genome shotgun sequence.	GCF0004818451	NZKI5192641	2394810	2429142	34332
Pseudomonas aeruginosa isolate LRJ17, whole genome shotgun sequence.	GCF9001482951	NZFRWR010000471	43197	57955	14758
Pseudomonas aeruginosa strain AZPAE15045 AZPAE15045_contig_30, whole genome shotgun sequence.	GCF0007909851	NZJTNB010000301	4639	30287	25648
Pseudomonas aeruginosa C1913C contig6, whole genome shotgun sequence	GCF0007051551	NZJGZX010000061	136045	187848	51803
Pseudomonas aeruginosa genome assembly 229_12_5Pc_5_contgs_500, contig NODE_18_length_149508_cov_28.3027_ID_35, whole genome shotgun sequence.	GCF0013747751	NZCTDA010000701	78411	98212	19801
Pseudomonas aeruginosa BWH035 adTzL-supercont1.14, whole genome shotgun sequence.	GCF0006290451	NZKK2120081	109772	123986	14214
Pseudomonas aeruginosa strain AZPAE14943 AZPAE14943_contig_14, whole genome shotgun sequence.	GCF0007913451	NZJTQY010000141	317	18251	17934
Pseudomonas aeruginosa isolate 158, whole genome shotgun sequence.	GCF9001450051	NZFRJN010000311	7781	27582	19801
Pseudomonas aeruginosa strain CR1 chromosome, complete genome	GCF0030253451	NZCP0205601	2374775	2389794	15019
Pseudomonas aeruginosa strain JYH6 IPC1217_1.1, whole genome shotgun sequence	GCF0038343251	NZNSOM010000011	42262	245353	203091
Pseudomonas aeruginosa strain MZ4A NODE_18_length_112827_cov_9.40698, whole genome shotgun sequence	GCF0097372251	NZWOVI010000181	82427	92824	10397
Pseudomonas aeruginosa isolate 189, whole genome shotgun sequence.	GCF9001453051	NZFRLF010000201	7781	34366	26585
Pseudomonas aeruginosa strain env345 NODE_15_length_152654_cov_7.29144, whole genome shotgun sequence.	GCF0023263551	NZNQZX010000151	46842	60706	13864
Pseudomonas aeruginosa strain AUS127 IPC197_3.1, whole genome shotgun sequence	GCF0038410851	NZNSZQ010000031	299650	326453	26803
Pseudomonas aeruginosa strain JYH18 IPC1229_12.1, whole genome shotgun sequence	GCF0038343951	NZNSOG010000121	45355	106515	61160
Pseudomonas aeruginosa strain delta6_2 chromosome	GCF0097999851	NZCP0470611	3079836	3099371	19535
Pseudomonas aeruginosa strain AZPAE12145 AZPAE12145_contig_10, whole genome shotgun sequence.	GCF0007967451	NZJUAR010000101	291422	327902	36480
Pseudomonas aeruginosa UCBPP-PA14 chromosome	GCF0069740451	NZCP0342441	2473700	2493501	19801
Pseudomonas aeruginosa strain PABL012 chromosome, complete genome	GCF0034291851	NZCP0316591	2528516	2547601	19085
Pseudomonas aeruginosa genome assembly 226_2_5Pc_1_contgs_500, contig NODE_2_length_451159_cov_22.9633_ID_3, whole genome shotgun sequence.	GCF0013747151	NZCTCZ010000251	78434	98235	19801
Pseudomonas aeruginosa strain PA_150567 NODE_1_length_849019_cov_15.7345, whole genome shotgun sequence	GCF0035852051	NZLSQQ010000141	476222	496023	19801
Pseudomonas aeruginosa genome assembly 231_15_121B_contgs_500, contig NODE_2_length_451136_cov_22.5443_ID_3, whole genome shotgun sequence.	GCF0013748151	NZCUXG010000391	78411	98212	19801
Pseudomonas aeruginosa strain N17-1, complete genome.	GCF0016060451	NZCP0149481	2399574	2429443	29869
Pseudomonas aeruginosa strain 6001 IPC1328_2.1, whole genome shotgun sequence	GCF0043720251	NZRWOH010000021	272650	307155	34505
Pseudomonas aeruginosa isolate 94, whole genome shotgun sequence.	GCF9001443751	NZFRHR010000101	157376	173158	15782
Pseudomonas aeruginosa strain Carb01 63, complete genome.	GCF0009818251	NZCP0113171	2914206	2986508	72302
Pseudomonas aeruginosa strain TNCF_151 NODE_1_length_601622_cov_25.6058_ID_1, whole genome shotgun sequence.	GCF0017661151	NZMAKK010000171	120372	167523	47151
Pseudomonas aeruginosa strain AR444 chromosome, complete genome.	GCF0030736151	NZCP0290891	2840813	2896107	55294
Pseudomonas aeruginosa strain PhDW6 IPC880_8.1, whole genome shotgun sequence	GCF0038363451	NZNSSR010000081	82111	131086	48975
Pseudomonas aeruginosa genome assembly 271_Rw168_2_contgs_500, contig NODE_2_length_451159_cov_11.8641_ID_3, whole genome shotgun sequence.	GCF0013752151	NZCTFC010000191	78434	98235	19801
Pseudomonas aeruginosa strain PA-CL524 IPC620_5.1, whole genome shotgun sequence	GCF0043727051	NZRWPP010000051	478108	488155	10047
Pseudomonas aeruginosa strain VET-23 NODE_14_length_158145_cov_22.0805_ID_27, whole genome shotgun sequence	GCF0036290451	NZRAFQ010000681	80087	109970	29883
Pseudomonas aeruginosa strain AR_0054 scaffold00002, whole genome shotgun sequence.	GCF0018751651	NZMPBV010000021	777987	866690	88703
Pseudomonas aeruginosa strain 295s071211BSL_PA2 IPC67_3.1, whole genome shotgun sequence	GCF0043743651	NZRWTZ010000031	186436	234528	48092
Pseudomonas aeruginosa strain PASGNDM345 chromosome, complete genome.	GCF0021046151	NZCP0207031	2532744	2592928	60184
Pseudomonas aeruginosa strain 24Pae112 chromosome, complete genome	GCF0034332351	NZCP0296051	2481354	2510578	29224
Pseudomonas aeruginosa genome assembly 205_12_5Pc_3_contgs_500, contig NODE_5_length_342265_cov_20.1151_ID_9, whole genome shotgun sequence.	GCF0013754151	NZCUWV010000341	26385	38822	12437
Pseudomonas aeruginosa genome assembly 205_12_5Pc_3_contgs_500, contig NODE_17_length_149523_cov_20.8083_ID_33, whole genome shotgun sequence.	GCF0013754151	NZCUWV010000381	78411	98212	19801
Pseudomonas aeruginosa strain CCBH4851 genome.	GCF0007632452	NZCP0213801	6107542	6160295	52753
Pseudomonas aeruginosa strain PAC46A IPC114_1.1, whole genome shotgun sequence	GCF0043745251	NZRWTL010000011	499897	521623	21726
Pseudomonas aeruginosa strain S1e NODE_6_length_296741_cov_18.1808, whole genome shotgun sequence.	GCF0023263051	NZNQZR010000061	61914	71248	9334
Pseudomonas aeruginosa strain env224 NODE_3_length_415345_cov_8.84131, whole genome shotgun sequence.	GCF0023305551	NZNRFV010000031	118095	139168	21073
Pseudomonas aeruginosa strain F2-1206 1206115_S36_R2_001_contig_23, whole genome shotgun sequence.	GCF0033256251	NZQORA010001511	43829	95428	51599
Pseudomonas aeruginosa BWH052 adTvf-supercont1.1, whole genome shotgun sequence.	GCF0006295451	NZKK2132501	1568724	1615875	47151
Pseudomonas aeruginosa isolate 151, whole genome shotgun sequence.	GCF9001449351	NZFRJJ010000501	101780	127428	25648
Pseudomonas sp. YS-1p CONTIG.132, whole genome shotgun sequence.	GCF0007575051	NZJPYP010000341	192286	216067	23781
Pseudomonas aeruginosa strain VET-75 PA2_B10_NODE_37_length_32241_cov_24.6513_ID_73, whole genome shotgun sequence	GCF0036300551	NZRADR010001831	12615	28944	16329
Pseudomonas aeruginosa strain AZPAE14526 AZPAE14526_contig_11, whole genome shotgun sequence.	GCF0007964451	NZJTYA010000111	43111	64744	21633
Pseudomonas aeruginosa strain 6487 NODE_7_length_179700_cov_15.711863, whole genome shotgun sequence	GCF0079228951	NZVOJC010000071	46293	80775	34482
Pseudomonas aeruginosa strain AZPAE15055 AZPAE15055_contig_8, whole genome shotgun sequence.	GCF0007931851	NZJTMR010000081	190594	238905	48311
Pseudomonas aeruginosa strain Liverpool Epidemic Strain, whole genome shotgun sequence.	GCF0008244651	NZCCPH010000031	37741	121242	83501
Pseudomonas aeruginosa strain AR_0105 scaffold00002, whole genome shotgun sequence.	GCF0018749951	NZMPBO010000021	447917	482988	35071
Pseudomonas aeruginosa strain Zw115 IPC1390_10.1, whole genome shotgun sequence	GCF0039746051	NZRXAR010000101	186581	246905	60324
Pseudomonas aeruginosa strain Environ_1 chromosome	GCF0098001451	NZCP0470691	3000071	3008681	8610
Pseudomonas aeruginosa strain UAEM 02 NODE_1_length_891545_cov_91.3093_ID_1, whole genome shotgun sequence.	GCF0022041551	NZMYFK010000081	379018	414408	35390
Pseudomonas sp. P179 genomic scaffold acBRO-supercont1.1, whole genome shotgun sequence.	GCF0004784852	NZKI5173541	641446	676653	35207
Pseudomonas aeruginosa strain Env_47 contig-2000073, whole genome shotgun sequence.	GCF0022394851	NZNLBA010000741	424668	439531	14863
Pseudomonas aeruginosa strain NCTC11452, whole genome shotgun sequence.	GCF9004551451	NZUATW010000131	319447	356050	36603
Pseudomonas aeruginosa strain AUS452 IPC270_2.1, whole genome shotgun sequence	GCF0039766451	NZRXFC010000021	300652	328666	28014
Pseudomonas aeruginosa strain AZPAE13864 AZPAE13864_contig_39, whole genome shotgun sequence.	GCF0007955651	NZJTZI010000381	41985	100610	58625
Pseudomonas aeruginosa isolate 82.1, whole genome shotgun sequence.	GCF9001480451	NZFRVR010000091	392996	409823	16827
Pseudomonas aeruginosa strain WH-SGI-V-07710 WH-SGI-V-07710_contig2, whole genome shotgun sequence.	GCF0014537751	NZLLTE010000121	354107	373818	19711
Pseudomonas aeruginosa strain NCTC11450, whole genome shotgun sequence.	GCF9004551651	NZUATT010000231	227669	262826	35157
Pseudomonas aeruginosa isolate 228, whole genome shotgun sequence.	GCF9001457051	NZFRMU010000171	296948	318419	21471
Pseudomonas aeruginosa PAO1 isolate 2017-D CEC17_22, whole genome shotgun sequence	GCF0039572051	NZQZFZ010000221	35074	54609	19535
Pseudomonas aeruginosa PS50 adkgi-supercont1.1, whole genome shotgun sequence.	GCF0005201751	NZKI9144331	2566938	2599158	32220
Pseudomonas aeruginosa strain H26023 chromosome, complete genome	GCF0037981451	NZCP0336851	2544626	2564427	19801
Pseudomonas aeruginosa strain AZPAE14820 AZPAE14820_contig_3, whole genome shotgun sequence.	GCF0007952251	NZJTVO010000031	145978	156294	10316
Pseudomonas aeruginosa BWHPSA047 adkfX-supercont1.1, whole genome shotgun sequence.	GCF0005202551	NZKI9144631	2420397	2452190	31793
Pseudomonas aeruginosa strain Ocean-222 scaffold9_cov368_read215, whole genome shotgun sequence.	GCF0022635751	NZNMRR010000081	168789	193210	24421
Pseudomonas aeruginosa DK1 genome assembly Pseudomonas aeruginosa DK1 substr. NH57388A, chromosome : I.	GCF9000690251	NZLN8702921	2409862	2431758	21896
Pseudomonas aeruginosa genome assembly 219_15_121A_contgs_500, contig NODE_12_length_210151_cov_24.5897_ID_23, whole genome shotgun sequence.	GCF0013745751	NZCUXC010000451	108619	128005	19386
Pseudomonas aeruginosa BWH060 adTvY-supercont1.2, whole genome shotgun sequence.	GCF0006293851	NZKK2131681	1764185	1779716	15531
Pseudomonas aeruginosa strain HUM-12-D2 NODE_14_length_156835_cov_35.2419_ID_27, whole genome shotgun sequence	GCF0036317851	NZRAAB010002151	51376	106708	55332
Pseudomonas aeruginosa isolate 123, whole genome shotgun sequence.	GCF9001446551	NZFRIU010000021	7788	38602	30814
Pseudomonas aeruginosa strain BH9 chromosome	GCF0037951651	NZCP0297131	2611926	2690789	78863
Pseudomonas aeruginosa DNA, complete genome, strain: NCGM 1900.	GCF0008292751	NZAP0146221	3870985	3900209	29224
Pseudomonas aeruginosa PAO1 isolate 2017-H CEC23_23, whole genome shotgun sequence	GCF0039571151	NZQZGD010000231	39321	53009	13688
Pseudomonas aeruginosa strain PA-CL521b IPC616_3.1, whole genome shotgun sequence	GCF0043722951	NZRWPR010000031	477791	488117	10326
Pseudomonas aeruginosa isolate 178, whole genome shotgun sequence.	GCF9001451951	NZFRKV010000941	41870	61581	19711
Pseudomonas aeruginosa strain F22031, complete genome.	GCF0008169851	NZCP0073991	5046181	5060639	14458
Pseudomonas aeruginosa strain PA_D21, complete genome.	GCF0017220451	NZCP0125821	2518244	2544571	26327
Pseudomonas aeruginosa strain CPHL8203 IPC734_4.1, whole genome shotgun sequence	GCF0038375251	NZNSTX010000041	59432	76966	17534
Pseudomonas aeruginosa strain 5990.3 IPC1313_1.1, whole genome shotgun sequence	GCF0043718051	NZRWOW010000011	301658	322210	20552
Pseudomonas aeruginosa strain AZPAE14889 AZPAE14889_contig_35, whole genome shotgun sequence.	GCF0007908051	NZJTSZ010000351	53761	117731	63970
Pseudomonas aeruginosa strain WH-SGI-V-07225 WH-SGI-V-07225_contig21, whole genome shotgun sequence.	GCF0014498351	NZLLMW010000541	42220	69509	27289
Pseudomonas aeruginosa strain MRSN16740 MRSN16740_contig00053, whole genome shotgun sequence	GCF0039693051	NZRXVP010000531	24499	62894	38395
Pseudomonas aeruginosa isolate 126, whole genome shotgun sequence.	GCF9001446851	NZFRIW010000751	97960	128774	30814
Pseudomonas aeruginosa strain 6086.1 IPC1332_3.1, whole genome shotgun sequence	GCF0043715351	NZRWOD010000031	44138	105263	61125
Pseudomonas aeruginosa strain L30 L30_L1.R1.clean_(paired)_contig_16, whole genome shotgun sequence	GCF0086326551	NZVWQG010000161	475238	504608	29370
Pseudomonas aeruginosa BWHPSA043 adkgk-supercont1.3, whole genome shotgun sequence.	GCF0005203351	NZKI9145051	358600	372979	14379
Pseudomonas aeruginosa strain ER06896 unitig_1, whole genome shotgun sequence	GCF0037036851	NZNTGC010000011	610618	644092	33474
Pseudomonas aeruginosa strain E80 chromosome, complete genome	GCF0042910751	NZCP0316771	2484597	2547447	62850
Pseudomonas aeruginosa strain AUS128 IPC371_3.1, whole genome shotgun sequence	GCF0039765551	NZRXET010000031	341993	376473	34480
Pseudomonas aeruginosa strain delta10 chromosome	GCF0098000851	NZCP0470661	3079843	3099378	19535
Pseudomonas aeruginosa isolate 133_Pseudo_aeruginosa, whole genome shotgun sequence.	GCF9001447551	NZFRJD010000421	38228	69042	30814
Pseudomonas aeruginosa strain ATCC BAA-2110 IPC1578_8.1, whole genome shotgun sequence.	GCF0022370751	NZMVGX010000081	221107	242735	21628
Pseudomonas aeruginosa strain AZPAE14398 AZPAE14398_contig_31, whole genome shotgun sequence.	GCF0007960951	NZJTYQ010000311	53761	109074	55313
Pseudomonas aeruginosa strain BTP038 MC15175182, whole genome shotgun sequence.	GCF0010867251	NZLFMV010000121	2455890	2482703	26813
Pseudomonas aeruginosa genome assembly 264_12_5Pc_1_2_contgs_500, contig NODE_2_length_451138_cov_24.7682_ID_3, whole genome shotgun sequence.	GCF0013750751	NZCUXQ010000451	78413	98214	19801
Pseudomonas aeruginosa strain PAC14B IPC137_1.1, whole genome shotgun sequence	GCF0043735651	NZRWSP010000011	445898	510790	64892
Pseudomonas aeruginosa strain P2404 IPC1110_1.1, whole genome shotgun sequence	GCF0039752151	NZRXCM010000011	515476	524703	9227
Pseudomonas aeruginosa BWHPSA014 genomic scaffold adgeT-supercont1.1, whole genome shotgun sequence.	GCF0004814251	NZKI5190761	2359840	2381472	21632
Pseudomonas aeruginosa strain A15 IPC692_3.1, whole genome shotgun sequence	GCF0038370251	NZNSUV010000031	404002	416447	12445
Pseudomonas aeruginosa genome assembly 201_Pa14_contgs_500, contig NODE_20_length_149509_cov_32.3687_ID_39, whole genome shotgun sequence.	GCF9000058451	NZCVON010000461	78411	98212	19801
Pseudomonas aeruginosa strain AZPAE14909 AZPAE14909_contig_2, whole genome shotgun sequence.	GCF0007895251	NZJTSG010000021	113118	132828	19710
Pseudomonas aeruginosa strain AZPAE14960 AZPAE14960_contig_6, whole genome shotgun sequence.	GCF0007917651	NZJTQH010000061	130621	158989	28368
Pseudomonas aeruginosa strain AZPAE14883 AZPAE14883_contig_6, whole genome shotgun sequence.	GCF0007906451	NZJTTF010000061	5788	40273	34485
Pseudomonas aeruginosa strain 1042828174-21 IPC1503_1.1, whole genome shotgun sequence	GCF0043704551	NZRWMP010000011	431255	479350	48095
Pseudomonas aeruginosa strain 6354 NODE_1_length_359690_cov_20.972968, whole genome shotgun sequence	GCF0079229051	NZVOJG010000011	159229	204443	45214
Pseudomonas aeruginosa BWH049 adTyP-supercont1.1, whole genome shotgun sequence.	GCF0006296051	NZKK2132811	1664213	1691026	26813
Pseudomonas aeruginosa strain AR439 chromosome, complete genome.	GCF0030738951	NZCP0290971	4742319	4752066	9747
Pseudomonas aeruginosa strain WH-SGI-V-07281 WH-SGI-V-07281_contig19, whole genome shotgun sequence.	GCF0014546451	NZLLUH010001011	21978	77712	55734
Pseudomonas aeruginosa strain AUS344 IPC495_3.1, whole genome shotgun sequence	GCF0038386951	NZNSWC010000031	481708	511078	29370
Pseudomonas aeruginosa strain PA-W37 IPC1296_3.1, whole genome shotgun sequence	GCF0038336251	NZNSND010000031	219715	263323	43608
Pseudomonas aeruginosa strain WH-SGI-V-07383 WH-SGI-V-07383_contig1, whole genome shotgun sequence.	GCF0014512451	NZLLOH010000011	470480	520638	50158
Pseudomonas aeruginosa isolate XDR-PA, whole genome shotgun sequence	GCF9007081551	NZCAADOD0100002151	19632	72410	52778
Pseudomonas aeruginosa strain HUM-291 NODE_16_length_105951_cov_13.0731_ID_31, whole genome shotgun sequence	GCF0036288751	NZRAFY010002641	7776	60554	52778
Pseudomonas aeruginosa DHS01, complete genome.	GCF0004964552	NZCP0139931	2670598	2729643	59045
Pseudomonas aeruginosa strain AUS516 IPC287_2.1, whole genome shotgun sequence	GCF0039765951	NZRXFB010000021	516179	525406	9227
Pseudomonas aeruginosa strain AR_0092 scaffold00001, whole genome shotgun sequence.	GCF0018748051	NZMPBS010000011	6749189	6779657	30468
Pseudomonas aeruginosa strain 1442 1442_NODE_2_length_392138_cov_72.3269, whole genome shotgun sequence	GCF0038639451	NZRRBD010000021	257269	311208	53939
Pseudomonas aeruginosa genome assembly 244_15_311Ga_contgs_500, contig NODE_18_length_149523_cov_36.07_ID_35, whole genome shotgun sequence.	GCF0013738351	NZCUXK010000471	78411	98212	19801
Pseudomonas aeruginosa isolate 247, whole genome shotgun sequence.	GCF9001458251	NZFRNF010000321	7789	23404	15615
Pseudomonas aeruginosa strain KCJ3K42 NODE_9_length_145349_cov_7.368884, whole genome shotgun sequence	GCF0088024951	NZVZIO010000091	82386	110837	28451
Pseudomonas aeruginosa strain G1-WATER-2A IPC1472_2.1, whole genome shotgun sequence	GCF0038339351	NZNSMP010000021	160157	175938	15781
Pseudomonas aeruginosa genome assembly 228_10Pc_8_contgs_500, contig NODE_16_length_149522_cov_28.465_ID_31, whole genome shotgun sequence.	GCF0013747551	NZCTCY010000421	78410	98211	19801
Pseudomonas aeruginosa strain HCF238 IPC1412_2.1, whole genome shotgun sequence	GCF0039745651	NZRXAJ010000021	625910	645532	19622
Pseudomonas aeruginosa strain SCH_ABX05 ABX05_contig000012, whole genome shotgun sequence.	GCF0020012651	NZMVBV010000121	112941	136333	23392
Pseudomonas aeruginosa strain U372 IPC948_3.1, whole genome shotgun sequence	GCF0038361251	NZNSRX010000031	477545	507428	29883
Pseudomonas aeruginosa BWH036 adTyH-supercont1.12, whole genome shotgun sequence.	GCF0006290251	NZKK2119421	80087	128182	48095
Pseudomonas aeruginosa strain ATCC 43731 scaffold_39, whole genome shotgun sequence.	GCF0014450051	NZLJZM010001671	38988	58796	19808
Pseudomonas aeruginosa BL25 genomic scaffold adgfY-supercont1.1, whole genome shotgun sequence.	GCF0004806451	NZKI5187501	702065	720639	18574
Pseudomonas aeruginosa strain MCF134 IPC1364_2.1, whole genome shotgun sequence	GCF0039746951	NZRXBI010000021	475156	497916	22760
Pseudomonas aeruginosa strain WH-SGI-V-07643 WH-SGI-V-07643_contig9, whole genome shotgun sequence.	GCF0014522551	NZLLRO010001001	68435	121188	52753
Pseudomonas aeruginosa NCAIM B.001380 K260DRAFT_scf7180000000062_quiver.15_C, whole genome shotgun sequence.	GCF0006858451	NZJMKR010000061	1286769	1296516	9747
Pseudomonas aeruginosa strain KCJ3K73 NODE_8_length_172901_cov_8.325576, whole genome shotgun sequence	GCF0088025651	NZVZIS010000081	39277	53493	14216
Pseudomonas aeruginosa strain LMG 1272 contig059, whole genome shotgun sequence	GCF0070510351	NZVIYL010000591	193159	204108	10949
Pseudomonas aeruginosa strain 5985 IPC1306_1.1, whole genome shotgun sequence	GCF0043719151	NZRWPD010000011	397522	445612	48090
Pseudomonas aeruginosa strain Y82 chromosome, complete genome.	GCF0033697551	NZCP0309121	2619571	2645114	25543
Pseudomonas aeruginosa isolate 411, whole genome shotgun sequence.	GCF9001473751	NZFRTE010001461	98675	118386	19711
Pseudomonas aeruginosa strain UMB151 NODE_6_length_125327_cov_5.931158, whole genome shotgun sequence	GCF0098075151	NZWUDO010000061	6547	62541	55994
Pseudomonas aeruginosa strain PA-W9 IPC5_1.1, whole genome shotgun sequence	GCF0038418051	NZNTAZ010000011	546089	583879	37790
Pseudomonas aeruginosa LESlike4 sequence.	GCF0005839951	NZCP0069851	2487920	2534779	46859
Pseudomonas aeruginosa strain U5b-2 NODE_2_length_356495_cov_14.044, whole genome shotgun sequence.	GCF0023259851	NZNQZD010000021	54026	76630	22604
Pseudomonas aeruginosa strain HUM-252 PA3_F3_NODE_5_length_263824_cov_43.5333_ID_9, whole genome shotgun sequence	GCF0036306951	NZRACM010000501	85428	144481	59053
Pseudomonas aeruginosa strain USDA-ARS-USMARC-41639, complete genome.	GCF0015189751	NZCP0139891	2485333	2489426	4093
Pseudomonas aeruginosa strain 1713 1713_NODE_12_length_135509_cov_82.9123, whole genome shotgun sequence	GCF0038634251	NZRRBY010000121	39318	87410	48092
Pseudomonas aeruginosa C2159M contig6, whole genome shotgun sequence	GCF0007052151	NZJGZZ010000051	95922	141985	46063
Pseudomonas aeruginosa strain HUM-260 PA3_E4_NODE_9_length_225573_cov_28.291_ID_17, whole genome shotgun sequence	GCF0036324051	NZQZYI010001191	83150	102951	19801
Pseudomonas aeruginosa strain So098 IPC677_2.1, whole genome shotgun sequence	GCF0038371051	NZNSVA010000021	42262	104009	61747
Pseudomonas aeruginosa strain Zw31 IPC1381_2.1, whole genome shotgun sequence	GCF0039741951	NZRXAX010000021	742097	752421	10324
Pseudomonas aeruginosa strain KCJ3K250 NODE_29_length_68355_cov_6.361772, whole genome shotgun sequence	GCF0088026751	NZVZIW010000291	4630	28989	24359
Pseudomonas aeruginosa strain WH-SGI-V-07245 WH-SGI-V-07245_contig6, whole genome shotgun sequence.	GCF0014500951	NZLLNQ010000421	478480	526572	48092
Pseudomonas aeruginosa strain WH-SGI-V-07266 WH_SGI_V_07266_1, whole genome shotgun sequence.	GCF0014539851	NZLLTX010000011	43893	69175	25282
Pseudomonas aeruginosa strain AZPAE15059 AZPAE15059_contig_17, whole genome shotgun sequence.	GCF0007932451	NZJTMN010000171	4632	29053	24421
Pseudomonas aeruginosa strain HUM-303 PA3_A9_NODE_1_length_644010_cov_45.3394_ID_1, whole genome shotgun sequence	GCF0036290051	NZRAFS010000091	316921	394991	78070
Pseudomonas aeruginosa strain PAC98C IPC170_2.1, whole genome shotgun sequence	GCF0043737251	NZRWRK010000021	421865	456371	34506
Pseudomonas aeruginosa isolate 246, whole genome shotgun sequence.	GCF9001458151	NZFRNH010000371	51975	73437	21462
Pseudomonas aeruginosa strain E6130952 chromosome, complete genome.	GCF0020857551	NZCP0206031	2594843	2624067	29224
Pseudomonas aeruginosa M18 chromosome, complete genome.	GCF0002261551	NC0175481	2419658	2432968	13310
Pseudomonas aeruginosa strain WH-SGI-V-07294 WH_SGI_V_07294_3, whole genome shotgun sequence.	GCF0014541751	NZLLUQ010000231	475950	491565	15615
Pseudomonas aeruginosa strain FDAARGOS_501 chromosome, complete genome	GCF0038129051	NZCP0338431	5143794	5173018	29224
Pseudomonas aeruginosa 3581 adTwT-supercont1.1, whole genome shotgun sequence.	GCF0006291651	NZKK2123991	475821	503139	27318
Pseudomonas aeruginosa strain UMB2253 NODE_5_length_148829_cov_5.884386, whole genome shotgun sequence	GCF0098072951	NZWUDI010000051	70828	119082	48254
Pseudomonas aeruginosa MSH3 genomic scaffold adgeF-supercont1.1, whole genome shotgun sequence.	GCF0004819851	NZKI5192981	3014301	3038516	24215
Pseudomonas aeruginosa strain PA_D16, complete genome.	GCF0017218051	NZCP0125811	2518245	2544572	26327
Pseudomonas aeruginosa strain AMT0005-138 IPC543_1.1, whole genome shotgun sequence	GCF0038385851	NZNSVT010000011	495337	509201	13864
Pseudomonas aeruginosa strain ATCC 33351 scaffold_26, whole genome shotgun sequence.	GCF0014202451	NZLJNX010000271	42163	58332	16169
Pseudomonas aeruginosa isolate B10W, complete genome.	GCF0018744651	NZCP0179691	2286477	2304988	18511
Pseudomonas aeruginosa strain NCTC8506, whole genome shotgun sequence.	GCF9004555651	NZUAWV010000091	173188	193898	20710
Pseudomonas aeruginosa strain PA-W21 IPC1287_1.1, whole genome shotgun sequence	GCF0038340851	NZNSNM010000011	1364607	1399089	34482
Pseudomonas aeruginosa isolate 125, whole genome shotgun sequence.	GCF9001446751	NZFRIV010000021	103988	140649	36661
Pseudomonas aeruginosa strain 313s141011BSL_PA1 IPC70_2.1, whole genome shotgun sequence	GCF0043746251	NZRWTX010000021	475060	497664	22604
Pseudomonas aeruginosa strain WH-SGI-V-07706 WH-SGI-V-07706_contig19, whole genome shotgun sequence.	GCF0014527251	NZLLTA010000111	88531	106095	17564
Pseudomonas aeruginosa strain L31 L31_L1.R1.clean_(paired)_contig_22, whole genome shotgun sequence	GCF0086298751	NZVWQF010000221	59686	115586	55900
Pseudomonas aeruginosa isolate 201.1, whole genome shotgun sequence.	GCF9001478351	NZFRUY010000211	35044	48260	13216
Pseudomonas aeruginosa strain AZPAE14973 AZPAE14973_contig_46, whole genome shotgun sequence.	GCF0007920651	NZJTPV010000461	33914	61232	27318
Pseudomonas aeruginosa strain ATCC 43390 scaffold_0, whole genome shotgun sequence.	GCF0014449251	NZLJZL010000011	42132	100732	58600
Pseudomonas aeruginosa BL23 genomic scaffold adgfb-supercont1.3, whole genome shotgun sequence.	GCF0004806851	NZKI5187741	294429	311825	17396
Pseudomonas aeruginosa strain WH-SGI-V-07236 WH-SGI-V-07236_contig2, whole genome shotgun sequence.	GCF0014507451	NZLLNH010000121	522017	539582	17565
Pseudomonas aeruginosa strain 6092.2 IPC1339_3.1, whole genome shotgun sequence	GCF0043714051	NZRWNW010000031	327961	347496	19535
Pseudomonas aeruginosa strain KY1 Contig_12, whole genome shotgun sequence.	GCF0008135651	NZJWJU010000121	42357	74065	31708
Pseudomonas aeruginosa strain 5BR2 IPC713_5.1, whole genome shotgun sequence	GCF0038368151	NZNSUJ010000051	75467	85701	10234
Pseudomonas aeruginosa isolate 371, whole genome shotgun sequence.	GCF9001469851	NZFRRT010000741	393911	498428	104517
Pseudomonas aeruginosa strain PAC78B IPC149_1.1, whole genome shotgun sequence	GCF0043734151	NZRWSE010000011	599507	643115	43608
Pseudomonas aeruginosa strain U0284 IPC924_1.1, whole genome shotgun sequence	GCF0038581251	NZNSSD010000011	477737	507620	29883
Pseudomonas aeruginosa strain FM4 IPC1429_1.1, whole genome shotgun sequence	GCF0039738951	NZRWZY010000011	428952	451278	22326
Pseudomonas aeruginosa strain AMT0006-64 IPC545_3.1, whole genome shotgun sequence	GCF0039754851	NZRXDN010000031	478022	526117	48095
Pseudomonas aeruginosa strain AU10241 NODE_2_length_614601_cov_5.60667_ID_3, whole genome shotgun sequence.	GCF0015543851	NZLRYK010000221	435247	454958	19711
Pseudomonas aeruginosa strain Jp97 IPC749_1.1, whole genome shotgun sequence	GCF0038375051	NZNSTP010000011	486506	503333	16827
Pseudomonas aeruginosa 9BR 9BRScaffold1, whole genome shotgun sequence.	GCF0002239251	NZAFXI010000011	3356137	3414737	58600
Pseudomonas aeruginosa strain U451 IPC976_1.1, whole genome shotgun sequence	GCF0038370851	NZNSRS010000011	477737	507620	29883
Pseudomonas aeruginosa strain AUS026 IPC334_1.1, whole genome shotgun sequence	GCF0038394651	NZNSYA010000011	301973	325282	23309
Pseudomonas aeruginosa strain PAO1161 chromosome, complete genome	GCF0041026651	NZCP0321261	2415989	2429677	13688
Pseudomonas aeruginosa strain MUC-N2, whole genome shotgun sequence	GCF0088430851	NZWBZG010000261	34997	54532	19535
Pseudomonas aeruginosa isolate 277, whole genome shotgun sequence.	GCF9001460751	NZFROF010000031	7785	66830	59045
Pseudomonas aeruginosa strain AZPAE12136 AZPAE12136_contig_11, whole genome shotgun sequence.	GCF0007965551	NZJUAY010000101	71050	90819	19769
Pseudomonas aeruginosa strain AZPAE15049 AZPAE15049_contig_17, whole genome shotgun sequence.	GCF0007894851	NZJTMX010000171	39289	62490	23201
Pseudomonas aeruginosa strain PA17 contig000003, whole genome shotgun sequence.	GCF0033327951	NZQDGR010000031	304223	368483	64260
Pseudomonas aeruginosa strain AUS491 IPC440_2.1, whole genome shotgun sequence	GCF0038404951	NZNSWX010000021	22671	50179	27508
Pseudomonas aeruginosa strain Pb18 genome.	GCF0021170451	NZCP0156501	436308	446630	10322
Pseudomonas aeruginosa strain AR_455 chromosome, complete genome.	GCF0032883551	NZCP0303281	4107228	4124095	16867
Pseudomonas aeruginosa strain PA7790, complete genome.	GCF0018702651	NZCP0149991	2468008	2520761	52753
Pseudomonas aeruginosa strain WH-SGI-V-07232 WH-SGI-V-07232_contig14, whole genome shotgun sequence.	GCF0014499351	NZLLND010000101	45296	106456	61160
Pseudomonas aeruginosa strain FA-HZ1, complete genome.	GCF0017507051	NZCP0173531	5325297	5372177	46880
Pseudomonas aeruginosa strain NCTC11445 genome assembly, chromosome: 1	GCF9006367351	NZLR1343081	3019057	3054009	34952
Pseudomonas aeruginosa strain CCBH276 scaffold_7, whole genome shotgun sequence	GCF0047858351	NZSRPL010000081	157843	162795	4952
Pseudomonas aeruginosa strain Li010 scaffold20.1, whole genome shotgun sequence.	GCF0017565251	NZLZTM010000131	22037	77771	55734
Pseudomonas aeruginosa strain AZPAE14958 AZPAE14958_contig_12, whole genome shotgun sequence.	GCF0007917251	NZJTQJ010000121	113121	171826	58705
Pseudomonas aeruginosa BWHPSA025 genomic scaffold adggk-supercont1.1, whole genome shotgun sequence.	GCF0004812051	NZKI5189921	2424081	2440247	16166
Pseudomonas aeruginosa isolate RW109 genome assembly, chromosome: Mainomosome.	GCF9002433551	NZLT9695201	2751201	2774375	23174
Pseudomonas aeruginosa strain PB350 chromosome, complete genome.	GCF0028129051	NZCP0250551	2539921	2569145	29224
Pseudomonas aeruginosa strain VNMU148 MRSN567310_contig00006, whole genome shotgun sequence	GCF0098877051	NZWXZT010000061	401793	429093	27300
Pseudomonas aeruginosa strain AZPAE14695 AZPAE14695_contig_56, whole genome shotgun sequence.	GCF0007946651	NZJTXJ010000561	38985	58786	19801
Pseudomonas aeruginosa strain TNCF_88M NODE_6_length_321101_cov_22.1428_ID_11, whole genome shotgun sequence.	GCF0017658451	NZMAZT010000181	83369	130520	47151
Pseudomonas aeruginosa strain S1g NODE_1_length_565722_cov_19.8935, whole genome shotgun sequence.	GCF0023262751	NZNQZQ010000011	54026	63360	9334
Pseudomonas aeruginosa strain TNCF_155_1 NODE_11_length_220360_cov_14.8314_ID_21, whole genome shotgun sequence.	GCF0017659951	NZMBML010000221	120450	167602	47152
Pseudomonas aeruginosa strain env334 NODE_26_length_73652_cov_14.2463, whole genome shotgun sequence.	GCF0023305251	NZNRFS010000261	4645	19718	15073
Pseudomonas aeruginosa isolate 149.1, whole genome shotgun sequence.	GCF9001477751	NZFRUS010001181	102282	127930	25648
Pseudomonas aeruginosa BWHPSA048 adkfS-supercont1.1, whole genome shotgun sequence.	GCF0005202351	NZKI9144611	2379195	2427077	47882
Pseudomonas aeruginosa MSH10 genomic scaffold adgfw-supercont1.1, whole genome shotgun sequence.	GCF0004819651	NZKI5192941	1725335	1743703	18368
Pseudomonas aeruginosa genome assembly 246_Rw30_contgs_500, contig NODE_3_length_451136_cov_26.9805_ID_5, whole genome shotgun sequence.	GCF0013738751	NZCTDM010000351	78411	98212	19801
Pseudomonas aeruginosa isolate 206, whole genome shotgun sequence.	GCF9001454851	NZFRLX010000411	4505	26133	21628
Pseudomonas aeruginosa strain PABL049 NODE_5_length_241304_cov_59.6101, whole genome shotgun sequence	GCF0034117451	NZQVCT010000051	41929	186778	144849
Pseudomonas aeruginosa strain MCF879 IPC1361_1.1, whole genome shotgun sequence	GCF0039758051	NZRXBL010000011	387849	452749	64900
Pseudomonas aeruginosa strain MRSN11278 MRSN11278_contig00043, whole genome shotgun sequence	GCF0039699551	NZRXWS010000431	65501	93991	28490
Pseudomonas aeruginosa strain VET-120 PA4_D4_NODE_9_length_237316_cov_40.6089_ID_17, whole genome shotgun sequence	GCF0036299951	NZRADU010000191	80104	101060	20956
Pseudomonas aeruginosa isolate paerg011 genome assembly, chromosome: 0	GCF9006183251	NZLR1305351	2372017	2411040	39023
Pseudomonas aeruginosa strain AUS021 IPC494_3.1, whole genome shotgun sequence	GCF0038403851	NZNSWD010000031	475395	504765	29370
Pseudomonas aeruginosa strain W25637 contig1, whole genome shotgun sequence.	GCF0029270351	NZJPFE010000011	2596188	2678758	82570
Pseudomonas aeruginosa strain DUN-006 IPC1005_1.1, whole genome shotgun sequence	GCF0038351851	NZNSRD010000011	347193	372841	25648
Pseudomonas aeruginosa strain HOU1 chromosome, complete genome	GCF0082451851	NZCP0422691	2288603	2305555	16952
Pseudomonas aeruginosa strain HUM-386 PA2_B8_NODE_2_length_282869_cov_54.514_ID_3, whole genome shotgun sequence	GCF0036294351	NZRAEX010001301	17914	80764	62850
Pseudomonas aeruginosa genome assembly 206_15Pc_2_contgs_500, contig NODE_18_length_149523_cov_25.7679_ID_35, whole genome shotgun sequence.	GCF0013754351	NZCUWW010000481	78411	98212	19801
Pseudomonas aeruginosa strain T2101 chromosome, complete genome	GCF0097204251	NZCP0399901	2823909	2841443	17534
Pseudomonas aeruginosa strain 5024382749-14 IPC1506_21.1, whole genome shotgun sequence	GCF0043704351	NZRWMM010000211	55261	78578	23317
Pseudomonas aeruginosa strain Liverpool Epidemic Strain, whole genome shotgun sequence.	GCF0008243451	NZCCPE010000031	54415	130499	76084
Pseudomonas aeruginosa strain AZPAE12411 AZPAE12411_contig_26, whole genome shotgun sequence.	GCF0007970551	NZJUAD010000261	66330	76804	10474
Pseudomonas aeruginosa strain SCAID WND3-2019 chromosome	GCF0075671251	NZCP0417851	1477650	1479664	2014
Pseudomonas aeruginosa strain Jp1155 IPC758_13.1, whole genome shotgun sequence	GCF0039753051	NZRXDA010000131	126113	159943	33830
Pseudomonas aeruginosa strain AUS439 IPC474_3.1, whole genome shotgun sequence	GCF0038388651	NZNSWK010000031	43445	53192	9747
Pseudomonas aeruginosa strain HUM-270 PA3_F5_NODE_1_length_506729_cov_47.814_ID_1, whole genome shotgun sequence	GCF0036322251	NZQZYT010000261	237890	259519	21629
Pseudomonas aeruginosa strain 559543 contig_49, whole genome shotgun sequence.	GCF0019095851	NZMPUZ010000491	80338	96119	15781
Pseudomonas aeruginosa genome assembly 203_2_5Pc_7_contgs_500, contig NODE_15_length_149508_cov_23.1713_ID_29, whole genome shotgun sequence.	GCF0013753751	NZCTCL010000731	78411	98212	19801
Pseudomonas aeruginosa LCT-PA41 Scaffold001, whole genome shotgun sequence.	GCF0004398751	NZKE5032231	509850	519284	9434
Pseudomonas aeruginosa strain MRSN6220 MRSN6220_contig00091, whole genome shotgun sequence	GCF0039682151	NZRXTM010000911	24485	64999	40514
Pseudomonas aeruginosa strain Pae74, whole genome shotgun sequence	GCF0040539351	NZSBJZ010000061	85405	224076	138671
Pseudomonas aeruginosa strain U435 IPC971_1.1, whole genome shotgun sequence	GCF0038360351	NZNSRT010000011	481209	483727	2518
Pseudomonas aeruginosa strain U3484 GCID_CRPK_0011_NODE_17.ctg_1, whole genome shotgun sequence	GCF0039543551	NZRWWM010001011	31268	83628	52360
Pseudomonas aeruginosa strain AUS165 IPC404_3.1, whole genome shotgun sequence	GCF0038390851	NZNSXD010000031	479765	497699	17934
Pseudomonas aeruginosa strain AR_0446 chromosome, complete genome.	GCF0031936451	NZCP0296601	1154643	1192463	37820
Pseudomonas aeruginosa strain IMP67 chromosome, complete genome	GCF0080337251	NZCP0288481	2446670	2462285	15615
Pseudomonas aeruginosa strain S518_C10_BS S518_C10_BS_NODE_5_length_348612, whole genome shotgun sequence.	GCF0021359951	NZNFGB010000051	113182	132892	19710
Pseudomonas aeruginosa strain 5988.2 IPC1308_1.1, whole genome shotgun sequence	GCF0043718451	NZRWPB010000011	617164	649103	31939
Pseudomonas aeruginosa strain PA-W4 IPC1282_2.1, whole genome shotgun sequence	GCF0038337851	NZNSNR010000021	238790	248017	9227
Pseudomonas aeruginosa strain AUS155 IPC394_1.1, whole genome shotgun sequence	GCF0039764251	NZRXEN010000011	354331	394101	39770
Pseudomonas aeruginosa isolate 281, whole genome shotgun sequence.	GCF9001461151	NZFROI010000571	206847	271739	64892
Pseudomonas aeruginosa genome assembly 295_Rw176_contgs_500, contig NODE_12_length_144113_cov_33.8776_ID_23, whole genome shotgun sequence.	GCF0013743751	NZCUYF010000091	44986	64971	19985
Pseudomonas aeruginosa strain Pa1060 K22_S95_R1__paired__contig_27, whole genome shotgun sequence	GCF0036699751	NZNRBU010000271	121940	177145	55205
Pseudomonas aeruginosa strain F30658, complete genome.	GCF0015162651	NZCP0088571	91316	173885	82569
Pseudomonas aeruginosa strain NCTC10727, whole genome shotgun sequence.	GCF9004554351	NZUAUH010000231	9058	33417	24359
Pseudomonas aeruginosa strain L6-1 contig0001, whole genome shotgun sequence.	GCF0014832351	NZLOJK010000011	1636592	1651379	14787
Pseudomonas aeruginosa genome assembly 249_Tsb_4_contgs_500, contig NODE_2_length_451159_cov_17.8911_ID_3, whole genome shotgun sequence.	GCF0013739551	NZCUXN010000291	78434	98235	19801
Pseudomonas aeruginosa isolate 160, whole genome shotgun sequence.	GCF9001450251	NZFRJQ010000841	101797	127445	25648
Pseudomonas aeruginosa BL22 genomic scaffold adgff-supercont1.1, whole genome shotgun sequence.	GCF0004807051	NZKI5187811	1376424	1380932	4508
Pseudomonas aeruginosa strain Liverpool Epidemic Strain, whole genome shotgun sequence.	GCF0008245651	NZCCOQ010000031	17226	93172	75946
Pseudomonas aeruginosa strain CL232 contig_109, whole genome shotgun sequence.	GCF0019097751	NZMPVE010001091	4650	30298	25648
Pseudomonas aeruginosa strain MRSN1613 MRSN1613_contig00003, whole genome shotgun sequence	GCF0039693951	NZRXVU010000031	687427	718761	31334
Pseudomonas aeruginosa strain PAC44C IPC156_1.1, whole genome shotgun sequence	GCF0043733051	NZRWRX010000011	301485	355424	53939
Pseudomonas aeruginosa isolate 414, whole genome shotgun sequence.	GCF9001473951	NZFRTF010001551	7787	21651	13864
Pseudomonas aeruginosa strain F462 isolate CPHL9433 IPC95_2.1, whole genome shotgun sequence	GCF0036987651	NZMCMO010000021	144137	178273	34136
Pseudomonas aeruginosa isolate 150, whole genome shotgun sequence.	GCF9001449251	NZFRJI010001321	7781	27582	19801
Pseudomonas aeruginosa PAO581 genome.	GCF0004685552	NC0223611	2859444	2878979	19535
Pseudomonas aeruginosa strain VD329 scaffold_1, whole genome shotgun sequence.	GCF0023125051	NZMWYR010000021	409572	449181	39609
Pseudomonas aeruginosa strain AR_0100 scaffold00001, whole genome shotgun sequence.	GCF0018749751	NZMPBQ010000011	666879	701950	35071
Pseudomonas aeruginosa strain TNCF_23M NODE_12_length_179680_cov_25.6866_ID_23, whole genome shotgun sequence.	GCF0017656551	NZMAZK010000171	120416	167567	47151
Pseudomonas aeruginosa BL06 genomic scaffold adgfq-supercont1.1, whole genome shotgun sequence.	GCF0004810251	NZKI5189151	1710565	1767568	57003
Pseudomonas aeruginosa strain HUM-294 NODE_17_length_119020_cov_23.7397_ID_33, whole genome shotgun sequence	GCF0036320451	NZQZZJ010000631	5788	40125	34337
Pseudomonas otitidis strain DSM 17224, whole genome shotgun sequence.	GCF9001118351	NZFOJP010000041	287673	296918	9245
Pseudomonas aeruginosa strain PA59 chromosome, complete genome	GCF0094976751	NZCP0246301	2450300	2472479	22179
Pseudomonas aeruginosa MRSN 321 contig10, whole genome shotgun sequence.	GCF0009821551	NZLBIG010000101	1666355	1689672	23317
Pseudomonas aeruginosa strain B2 IPC1040_2.1, whole genome shotgun sequence	GCF0038356651	NZNSQQ010000021	191777	217425	25648
Pseudomonas aeruginosa strain 326S290611BSL_PA3 IPC77_20.1, whole genome shotgun sequence	GCF0043745951	NZRWTQ010000201	85603	97752	12149
Pseudomonas aeruginosa genome assembly 257_Tsb_Bead_Pool_1_contgs_500, contig NODE_1_length_451159_cov_21.9587_ID_1, whole genome shotgun sequence.	GCF0013749351	NZCTDT010000241	78434	98235	19801
Pseudomonas aeruginosa isolate PSA-11, whole genome shotgun sequence	GCF9001061351	NZFNLS010000201	315968	348625	32657
Pseudomonas aeruginosa strain 2253 2253_NODE_1.ctg_1, whole genome shotgun sequence.	GCF0021937351	NZNIOL010000801	501707	515571	13864
Pseudomonas aeruginosa strain AUS174 IPC411_2.1, whole genome shotgun sequence	GCF0039767751	NZRXEJ010000021	379406	404418	25012
Pseudomonas aeruginosa strain HUM-298 NODE_9_length_156720_cov_16.8313_ID_17, whole genome shotgun sequence	GCF0036297951	NZRAEF010000521	86748	148474	61726
Pseudomonas aeruginosa strain INP-43 chromosome, complete genome	GCF0099051951	NZCP0475921	3564871	3584033	19162
Pseudomonas aeruginosa strain AU12175 NODE_2_length_447248_cov_7.7445_ID_3, whole genome shotgun sequence.	GCF0015545351	NZLRYP010000221	353533	407470	53937
Pseudomonas aeruginosa PAO1-GFP adTym-supercont1.2, whole genome shotgun sequence.	GCF0006293451	NZKK2131551	1614512	1628200	13688
Pseudomonas aeruginosa isolate XDR-PA, whole genome shotgun sequence	GCF9007082851	NZCAADOS0100000801	32628	95629	63001
Pseudomonas aeruginosa strain TNCF_10 NODE_5_length_279070_cov_18.4718_ID_9, whole genome shotgun sequence.	GCF0017654751	NZMAUS010000321	41332	88483	47151
Pseudomonas aeruginosa strain CCBH17348 scaffold5.1, whole genome shotgun sequence.	GCF0022511251	NZNOKO010000051	333811	390469	56658
Pseudomonas aeruginosa strain AUS176 IPC413_5.1, whole genome shotgun sequence	GCF0039764451	NZRXEH010000051	46514	80996	34482
Pseudomonas aeruginosa 6077 genomic scaffold adgeN-supercont1.1, whole genome shotgun sequence.	GCF0004817451	NZKI5192161	1794675	1823899	29224
Pseudomonas aeruginosa strain D1 IPC1045_3.1, whole genome shotgun sequence	GCF0038349851	NZNSQO010000031	341336	406228	64892
Pseudomonas aeruginosa BWH051 adTzG-supercont1.1, whole genome shotgun sequence.	GCF0006295651	NZKK2132591	1402816	1452151	49335
Pseudomonas aeruginosa isolate 162, whole genome shotgun sequence.	GCF9001450451	NZFRJY010000051	7782	27583	19801
Pseudomonas aeruginosa strain TNCF_76 NODE_7_length_306248_cov_24.0762_ID_13, whole genome shotgun sequence.	GCF0017658051	NZMAZR010000181	247010	294160	47150
Pseudomonas aeruginosa strain UMB1204 NODE_51_length_43304_cov_5.707367, whole genome shotgun sequence	GCF0098075251	NZWUDK010000511	12874	30408	17534
Pseudomonas aeruginosa strain MRSN8136 MRSN8136_contig00005, whole genome shotgun sequence	GCF0039681251	NZRXTF010000051	101248	140898	39650
Pseudomonas aeruginosa strain AUS304 IPC327_1.1, whole genome shotgun sequence	GCF0038395051	NZNSYB010000011	35304	48520	13216
Pseudomonas aeruginosa strain AZPAE14898 AZPAE14898_contig_46, whole genome shotgun sequence.	GCF0007910351	NZJTSR010000461	24692	50340	25648
Pseudomonas aeruginosa strain 175BR IPC1241_8.1, whole genome shotgun sequence	GCF0038342651	NZNSOB010000081	166156	224756	58600
Pseudomonas aeruginosa strain WH-SGI-V-07620 WH-SGI-V-07620_contig1, whole genome shotgun sequence.	GCF0014533051	NZLLQR010000011	530579	555302	24723
Pseudomonas sp. HMSC065H01 Scaffold110, whole genome shotgun sequence.	GCF0018152351	NZKV8198621	382622	430714	48092
Pseudomonas aeruginosa strain AZPAE14850 AZPAE14850_contig_32, whole genome shotgun sequence.	GCF0007897851	NZJTUL010000321	4660	30308	25648
Pseudomonas aeruginosa strain AU6923 NODE_4_length_363059_cov_5.80555_ID_7, whole genome shotgun sequence.	GCF0015551451	NZLRYO010000411	144646	198583	53937
Pseudomonas aeruginosa strain Liverpool Epidemic Strain, whole genome shotgun sequence.	GCF0008240051	NZCCOI010000031	43176	118592	75416
Pseudomonas aeruginosa strain 5054408350-18 IPC1488_3.1, whole genome shotgun sequence	GCF0043706251	NZRWNC010000031	299622	329398	29776
Pseudomonas aeruginosa strain Cas9_1 chromosome	GCF0098001051	NZCP0470671	3079854	3099389	19535
Pseudomonas aeruginosa strain S440_C09_BS S440_C09_BS_NODE_3_length_462751, whole genome shotgun sequence.	GCF0021364451	NZNFGF010000031	113127	132839	19712
Pseudomonas aeruginosa strain TNCF_69 NODE_14_length_142604_cov_19.0481_ID_27, whole genome shotgun sequence.	GCF0017657551	NZMAZQ010000291	83366	130518	47152
Pseudomonas aeruginosa strain WH-SGI-V-07166 WH-SGI-V-07166_contig1, whole genome shotgun sequence.	GCF0014494851	NZLLLV010000011	278458	311168	32710
Pseudomonas aeruginosa strain AL561 IPC1353_2.1, whole genome shotgun sequence	GCF0038334551	NZNSMT010000021	475929	486410	10481
Pseudomonas aeruginosa genome assembly 254_15Pc_6_contgs_500, contig NODE_2_length_451136_cov_26.5722_ID_3, whole genome shotgun sequence.	GCF0013749151	NZCTDR010000371	78411	98212	19801
Pseudomonas aeruginosa strain PA-CL515 IPC609_2.1, whole genome shotgun sequence	GCF0043728051	NZRWPY010000021	203242	256249	53007
Pseudomonas aeruginosa C52 genomic scaffold adgfp-supercont1.2, whole genome shotgun sequence.	GCF0004803951	NZKI5186781	1741306	1745206	3900
Pseudomonas aeruginosa strain SP4371 chromosome, complete genome	GCF0039502551	NZCP0343691	1843344	1900444	57100
Pseudomonas aeruginosa strain BTP033 MC15175089, whole genome shotgun sequence.	GCF0010867351	NZLFMQ010000211	871596	900820	29224
Pseudomonas aeruginosa RB DNA, scaffold_PARB004, whole genome shotgun sequence.	GCF0006479351	NZDF3968061	479948	493493	13545
Pseudomonas aeruginosa strain AZPAE15025 AZPAE15025_contig_13, whole genome shotgun sequence.	GCF0007910051	NZJTNV010000131	382776	402577	19801
Pseudomonas aeruginosa strain Pae83, whole genome shotgun sequence	GCF0040539451	NZSBKB010000031	57105	102852	45747
Pseudomonas aeruginosa strain 278S180511BSL_PA2 IPC60_11.1, whole genome shotgun sequence	GCF0043743951	NZRWUE010000111	80218	128113	47895
Pseudomonas aeruginosa strain ST277 Contig_24, whole genome shotgun sequence	GCF0007632451	NZJPSS010000241	38560	97160	58600
Pseudomonas aeruginosa strain D9 3362 IPC1164_5.1, whole genome shotgun sequence	GCF0038344651	NZNSOX010000051	347348	372996	25648
Pseudomonas aeruginosa strain AR_0359 AR0359.contig.2_1, whole genome shotgun sequence.	GCF0030006951	NZPSQS010000031	6125579	6188428	62849
Pseudomonas aeruginosa genome assembly 232_15_221Ba_contgs_500, contig NODE_3_length_491893_cov_24.727_ID_5, whole genome shotgun sequence.	GCF0013748351	NZCUXJ010000301	420781	440582	19801
Pseudomonas aeruginosa SJTD-1, complete genome.	GCF0002719852	NZCP0158771	4851645	4884303	32658
Pseudomonas aeruginosa strain 59.20 IPC703_2.1, whole genome shotgun sequence	GCF0038369251	NZNSUN010000021	475094	501678	26584
Pseudomonas aeruginosa strain L32 L32_L1.R1.clean_(paired)_contig_19, whole genome shotgun sequence	GCF0086298151	NZVWQE010000191	498122	516696	18574
Pseudomonas aeruginosa strain IDEXX_Canine4 IPC723_2.1, whole genome shotgun sequence	GCF0038367651	NZNSUF010000021	347082	372730	25648
Pseudomonas aeruginosa strain M37351, complete genome.	GCF0015163851	NZCP0088631	965660	991308	25648
Pseudomonas aeruginosa strain MCF206 IPC1356_26.1, whole genome shotgun sequence	GCF0039748951	NZRXBN010000261	39619	49782	10163
Pseudomonas aeruginosa strain N15-01092, complete sequence	GCF0035715051	NZCP0129011	4331495	4418956	87461
Pseudomonas aeruginosa strain AR_458 chromosome, complete genome.	GCF0032884351	NZCP0303271	5643253	5672224	28971
Pseudomonas aeruginosa strain E-500 scaffold_0, whole genome shotgun sequence.	GCF0023124151	NZMWYJ010000011	353587	372744	19157
Pseudomonas aeruginosa isolate 194, whole genome shotgun sequence.	GCF9001453751	NZFRLL010001021	41872	115488	73616
Pseudomonas aeruginosa strain WH-SGI-V-07484 WH-SGI-V-07484_contig1, whole genome shotgun sequence.	GCF0014515651	NZLLPQ010000011	166097	224697	58600
Pseudomonas aeruginosa isolate 343, whole genome shotgun sequence.	GCF9001467151	NZFRQQ010000631	48310	73958	25648
Pseudomonas aeruginosa BL03 genomic scaffold adgeM-supercont1.1, whole genome shotgun sequence.	GCF0004810851	NZKI5189421	761266	781939	20673
Pseudomonas aeruginosa strain 7 IPC1589_1.1, whole genome shotgun sequence	GCF0043709651	NZRWLO010000011	208329	262268	53939
Pseudomonas aeruginosa strain ATCC 27853, complete genome	GCF0016872851	NZCP0118571	2364942	2368842	3900
Pseudomonas aeruginosa strain AL363(Israel 14) IPC1352_1.1, whole genome shotgun sequence	GCF0038339651	NZNSMU010000011	738600	748921	10321
Pseudomonas aeruginosa strain CLB24402 contig_64, whole genome shotgun sequence.	GCF0019101151	NZMPVH010000641	84393	104104	19711
Pseudomonas aeruginosa genome assembly 233_15_321Bb_contgs_500, contig NODE_2_length_451159_cov_22.3093_ID_3, whole genome shotgun sequence.	GCF0013748551	NZCTDB010000231	78434	98235	19801
Pseudomonas aeruginosa strain PABL068 NODE_2_length_439108_cov_71.7521, whole genome shotgun sequence	GCF0034112751	NZQVCB010000021	163598	188117	24519
Pseudomonas aeruginosa strain 14.1 IPC1596_3.1, whole genome shotgun sequence	GCF0043700451	NZRWLH010000031	541794	547428	5634
Pseudomonas aeruginosa strain PAC98B IPC169_1.1, whole genome shotgun sequence	GCF0043736751	NZRWRL010000011	421865	456371	34506
Pseudomonas aeruginosa strain AUS471 IPC282_6.1, whole genome shotgun sequence	GCF0038395451	NZNSYP010000061	99942	134424	34482
Pseudomonas aeruginosa strain PA1088, complete genome.	GCF0017928351	NZCP0150011	2437279	2490032	52753
Pseudomonas aeruginosa isolate 243, whole genome shotgun sequence.	GCF9001457851	NZFRNB010000641	7787	23402	15615
Pseudomonas aeruginosa strain 326S290611BSL_PA1 IPC75_2.1, whole genome shotgun sequence	GCF0043742651	NZRWTS010000021	472205	484354	12149
Pseudomonas aeruginosa strain 156 scaffold_3, whole genome shotgun sequence	GCF0043504551	NZSCXB010000041	33901	53065	19164
Pseudomonas aeruginosa strain AZPAE12420 AZPAE12420_contig_16, whole genome shotgun sequence.	GCF0007972851	NZJTZU010000161	248222	303159	54937
Pseudomonas aeruginosa strain TNCF_32M NODE_26_length_75386_cov_6.06353_ID_51, whole genome shotgun sequence.	GCF0017656351	NZMAZL010000571	16092	63243	47151
Pseudomonas aeruginosa strain MRSN12368 MRSN12368A_contig00093, whole genome shotgun sequence	GCF0039700051	NZRXWI010000931	45066	67857	22791
Pseudomonas aeruginosa strain 8489 NODE_2_length_390520_cov_52.2142, whole genome shotgun sequence.	GCF0029642551	NZPUEX010000021	61653	266131	204478
Pseudomonas aeruginosa BL10 genomic scaffold adgez-supercont1.1, whole genome shotgun sequence.	GCF0004809451	NZKI5188831	2422142	2456502	34360
Pseudomonas aeruginosa strain KCRI-318 isolate R0008_318, whole genome shotgun sequence.	GCF9004068351	NZOVCP010000311	4641	29935	25294
Pseudomonas aeruginosa strain AUS525 IPC246_3.1, whole genome shotgun sequence	GCF0039769451	NZRXFH010000031	86324	118756	32432
Pseudomonas aeruginosa strain VET-74 PA2_C9_NODE_18_length_42488_cov_34.6467_ID_35, whole genome shotgun sequence	GCF0036290551	NZRAFP010002041	13720	38729	25009
Pseudomonas aeruginosa strain Aa249 IPC858_13.1, whole genome shotgun sequence	GCF0038363051	NZNSSY010000131	7882	72774	64892
Pseudomonas aeruginosa strain SCH_ABX20 ABX20_contig000003, whole genome shotgun sequence.	GCF0019902851	NZMUKY010000031	167860	221810	53950
Pseudomonas aeruginosa strain 19R IPC577_2.1, whole genome shotgun sequence	GCF0043729051	NZRWQT010000021	185953	216740	30787
Pseudomonas aeruginosa strain VD564 scaffold_1, whole genome shotgun sequence.	GCF0023124951	NZMWYP010000021	85685	125294	39609
Pseudomonas aeruginosa strain WH-SGI-V-07408 WH-SGI-V-07408_contig1, whole genome shotgun sequence.	GCF0014512951	NZLLOV010000011	476320	496121	19801
Pseudomonas aeruginosa strain S432_C09_RS S432_C09_RS_NODE_3_length_586731, whole genome shotgun sequence.	GCF0021361151	NZNFGI010000031	236962	256675	19713
Pseudomonas aeruginosa strain CCBH5698 scaffold16.1, whole genome shotgun sequence	GCF0041457851	NZSELC010000161	83835	136588	52753
Pseudomonas aeruginosa strain UQCCR 462667354 AA24 NODE_3_length_131099_cov_36.6048, whole genome shotgun sequence	GCF0020881651	NZMWZG010000031	62840	91291	28451
Pseudomonas sp. HMSC066A08 Scaffold613, whole genome shotgun sequence.	GCF0018130251	NZKV8113051	498441	509991	11550
Pseudomonas aeruginosa strain PAC18A IPC144_1.1, whole genome shotgun sequence	GCF0043738051	NZRWSJ010000011	555316	598924	43608
Pseudomonas aeruginosa strain AZPAE15038 AZPAE15038_contig_13, whole genome shotgun sequence.	GCF0007901151	NZJTNI010000131	119467	141096	21629
Pseudomonas aeruginosa strain PA-W6 IPC2_1.1, whole genome shotgun sequence	GCF0038417751	NZNTBC010000011	484488	500364	15876
Pseudomonas aeruginosa strain AU23529 NODE_1_length_605024_cov_6.49707_ID_1, whole genome shotgun sequence.	GCF0015554251	NZLSAI010000111	271367	325302	53935
Pseudomonas aeruginosa strain HUM-244 PA3_H2_NODE_9_length_159595_cov_31.5468_ID_17, whole genome shotgun sequence	GCF0036329051	NZRAAE010000681	81981	137313	55332
Pseudomonas aeruginosa strain PAC23A IPC153_1.1, whole genome shotgun sequence	GCF0043733151	NZRWSA010000011	709957	763896	53939
Pseudomonas aeruginosa strain CCUG 51971 chromosome, complete genome	GCF0081954851	NZCP0433281	2658250	2687474	29224
Pseudomonas aeruginosa strain 5034388498-20 IPC1485_3.1, whole genome shotgun sequence	GCF0043712751	NZRWNF010000031	420626	482558	61932
Pseudomonas aeruginosa strain AR_0103 scaffold00001, whole genome shotgun sequence.	GCF0018747951	NZMPBP010000011	5243539	5332221	88682
Pseudomonas aeruginosa strain AMT0047-2 IPC566_1.1, whole genome shotgun sequence	GCF0039754051	NZRXDF010000011	298085	362976	64891
Pseudomonas aeruginosa strain 21BR IPC1245_1.1, whole genome shotgun sequence	GCF0038338651	NZNSNX010000011	166156	224756	58600
Pseudomonas aeruginosa strain AR_0360 chromosome, complete genome.	GCF0029685151	NZCP0271651	1184401	1198320	13919
Pseudomonas aeruginosa H1l COntig3, whole genome shotgun sequence.	GCF0006334951	NZAYML010000031	381573	415760	34187
Pseudomonas aeruginosa isolate 199, whole genome shotgun sequence.	GCF9001453951	NZFRLM010000761	7783	23564	15781
Pseudomonas aeruginosa isolate 412.1, whole genome shotgun sequence.	GCF9001479451	NZFRVK010002951	1852	21563	19711
Pseudomonas aeruginosa isolate 130, whole genome shotgun sequence.	GCF9001447251	NZFRJA010000561	97913	128727	30814
Pseudomonas aeruginosa strain SJU-W20_1 NODE_2_length_539633_cov_46.9179, whole genome shotgun sequence.	GCF0023297351	NZNREU010000021	477546	491410	13864
Pseudomonas aeruginosa BL05 genomic scaffold adgfv-supercont1.1, whole genome shotgun sequence.	GCF0004810451	NZKI5189281	1724841	1735321	10480
Pseudomonas aeruginosa strain AMT0046-108 IPC562_2.1, whole genome shotgun sequence	GCF0039754151	NZRXDH010000021	476142	500837	24695
Pseudomonas aeruginosa strain 282 scaffold_0, whole genome shotgun sequence.	GCF0023121151	NZMWXL010000011	409414	449023	39609
Pseudomonas aeruginosa genome assembly 274_2_5Pc_5_contgs_500, contig NODE_17_length_149523_cov_24.2222_ID_33, whole genome shotgun sequence.	GCF0013752751	NZCUXU010000281	78411	98212	19801
Pseudomonas aeruginosa strain L23 L23_L1.R1.clean_(paired)_contig_13, whole genome shotgun sequence	GCF0086299151	NZVWQL010000131	287239	311660	24421
Pseudomonas aeruginosa strain PAC15A IPC139_1.1, whole genome shotgun sequence	GCF0043735451	NZRWSO010000011	189693	212826	23133
Pseudomonas aeruginosa strain AR_0352 AR_352.contig.0_1, whole genome shotgun sequence.	GCF0033244651	NZQMGJ010000011	2306223	2326242	20019
Pseudomonas aeruginosa BWHPSA041 adkgd-supercont1.1, whole genome shotgun sequence.	GCF0005203751	NZKI9145151	1399046	1451799	52753
Pseudomonas aeruginosa CF_PA39 scaffold8, whole genome shotgun sequence	GCF0005682351	NZJDVE010000081	18199	65154	46955
Pseudomonas aeruginosa genome assembly 204_10Pc_6_contgs_500, contig NODE_18_length_149523_cov_34.5293_ID_35, whole genome shotgun sequence.	GCF0013753951	NZCTCM010000741	78411	98212	19801
Pseudomonas aeruginosa isolate 205, whole genome shotgun sequence.	GCF9001454751	NZFRLY010000321	35048	48264	13216
Pseudomonas aeruginosa BWHPSA018 genomic scaffold adgfT-supercont1.4, whole genome shotgun sequence.	GCF0004813451	NZKI5190571	246973	261080	14107
Pseudomonas aeruginosa strain 8488 NODE_1_length_664683_cov_28.1258, whole genome shotgun sequence.	GCF0029642951	NZPUEW010000011	247949	286345	38396
Pseudomonas aeruginosa strain HCF331 IPC1413_8.1, whole genome shotgun sequence	GCF0039739951	NZRXAI010000081	88036	108055	20019
Pseudomonas aeruginosa RB-48 contig6, whole genome shotgun sequence.	GCF0005681151	NZAZYL010000061	115566	129254	13688
Pseudomonas fluorescens strain NCTC10783 genome assembly, chromosome: 1	GCF9006366351	NZLR1343001	1401938	1415802	13864
Pseudomonas aeruginosa strain ATCC 9027 scaffold7_size203254, whole genome shotgun sequence.	GCF0014029551	NZLLKP010001231	13992	75306	61314
Pseudomonas aeruginosa strain PAC107A IPC126_1.1, whole genome shotgun sequence	GCF0043740651	NZRWSZ010000011	701965	750057	48092
Pseudomonas aeruginosa strain MRSN29192 MRSN29192_contig00007, whole genome shotgun sequence	GCF0039689851	NZRXUK010000071	473993	496160	22167
Pseudomonas aeruginosa isolate 436, whole genome shotgun sequence.	GCF9001476251	NZFRUE010000501	43191	57949	14758
Pseudomonas aeruginosa strain Env_1 contig-46, whole genome shotgun sequence.	GCF0022395651	NZNLBG010000461	42204	76377	34173
Pseudomonas aeruginosa strain WH-SGI-V-07230 WH-SGI-V-07230_contig4, whole genome shotgun sequence.	GCF0014507051	NZLLNB010000341	231388	245252	13864
Pseudomonas aeruginosa strain 145S200511BSL_PA2 IPC40_3.1, whole genome shotgun sequence	GCF0043752851	NZRWUW010000031	133613	149859	16246
Pseudomonas aeruginosa strain PAC76A IPC177_1.1, whole genome shotgun sequence	GCF0043730351	NZRWRD010000011	113054	127322	14268
Pseudomonas aeruginosa strain AZPAE12153 AZPAE12153_contig_19, whole genome shotgun sequence.	GCF0007969251	NZJUAJ010000191	122708	138489	15781
Pseudomonas aeruginosa strain KCRI-363 isolate R0007_363, whole genome shotgun sequence.	GCF9004069251	NZOVCX010000101	114662	143826	29164
Pseudomonas aeruginosa strain SJU-S79_3 NODE_8_length_283846_cov_53.7471, whole genome shotgun sequence.	GCF0023297651	NZNREY010000081	61498	70824	9326
Pseudomonas aeruginosa strain AUS449 IPC451_3.1, whole genome shotgun sequence	GCF0039755551	NZRXDW010000031	234614	251715	17101
Pseudomonas aeruginosa strain PA3448 chr, whole genome shotgun sequence.	GCF0018027351	NZLVWC010000011	5941736	5994489	52753
Pseudomonas aeruginosa strain 3020837212 IPC1517_1.1, whole genome shotgun sequence	GCF0043702851	NZRWMB010000011	593680	641772	48092
Pseudomonas aeruginosa isolate 280, whole genome shotgun sequence.	GCF9001461051	NZFROJ010000181	7422	66467	59045
Pseudomonas aeruginosa strain 5024379144-14 IPC1479_4.1, whole genome shotgun sequence	GCF0043713051	NZRWNI010000041	105297	109897	4600
Pseudomonas aeruginosa strain AU18274 NODE_2_length_579855_cov_5.98623_ID_3, whole genome shotgun sequence.	GCF0015549151	NZLRZO010000221	359689	419356	59667
Pseudomonas aeruginosa BWH053 adTyt-supercont1.1, whole genome shotgun sequence.	GCF0006295251	NZKK2132371	1665959	1670467	4508
Pseudomonas aeruginosa strain KOL-3 PA4_C4_NODE_3_length_430296_cov_52.3276_ID_5, whole genome shotgun sequence	GCF0036287951	NZRAGD010000621	35073	54608	19535
Pseudomonas aeruginosa strain AUS336 IPC308_1.1, whole genome shotgun sequence	GCF0038395851	NZNSYG010000011	1247475	1275815	28340
Pseudomonas aeruginosa DNA, complete genome, strain: IOMTU 133.	GCF0015483351	NZAP0173021	2747151	2762729	15578
Pseudomonas aeruginosa strain PA1RG, complete genome.	GCF0012930851	NZCP0126791	2475731	2494244	18513
Pseudomonas aeruginosa strain AUS527 IPC324_3.1, whole genome shotgun sequence	GCF0039769051	NZRXEZ010000031	405360	449602	44242
Pseudomonas aeruginosa strain AZPAE14929 AZPAE14929_contig_25, whole genome shotgun sequence.	GCF0007895351	NZJTRM010000251	260268	315562	55294
Pseudomonas aeruginosa strain AR_0459 AR_459.contig.0_1, whole genome shotgun sequence.	GCF0033242551	NZQMGQ010000011	2378762	2407733	28971
Pseudomonas aeruginosa strain WH-SGI-V-07708 WH-SGI-V-07708_contig5, whole genome shotgun sequence.	GCF0014545851	NZLLTC010000451	427556	454874	27318
Pseudomonas aeruginosa strain M63 NODE_26_length_81349_cov_20.8873, whole genome shotgun sequence	GCF0041233251	NZSDVH010000261	38144	63434	25290
Pseudomonas aeruginosa DNA, complete genome, strain: NCGM257.	GCF0015479551	NZAP0146511	2750628	2765585	14957
Pseudomonas aeruginosa MPAO1/P1 P1_contig_c41, whole genome shotgun sequence.	GCF0002474351	NZAHKM010000411	35159	54694	19535
Pseudomonas aeruginosa strain AZPAE14910 AZPAE14910_contig_2, whole genome shotgun sequence.	GCF0007899751	NZJTSF010000021	248368	265196	16828
Pseudomonas aeruginosa strain env299 NODE_18_length_118349_cov_17.3102, whole genome shotgun sequence.	GCF0023301351	NZNRFT010000181	39252	98305	59053
Pseudomonas aeruginosa strain AZPAE14962 AZPAE14962_contig_1, whole genome shotgun sequence.	GCF0007918051	NZJTQF010000011	117780	178940	61160
Pseudomonas aeruginosa strain PABL076 NODE_18_length_111209_cov_79.6556, whole genome shotgun sequence	GCF0034107651	NZQVBT010000181	42983	71434	28451
Pseudomonas aeruginosa strain Ocean-1175 chromosome, complete genome.	GCF0022374251	NZCP0225251	6187304	6220882	33578
Pseudomonas aeruginosa BWHPSA023 genomic scaffold adgeL-supercont1.5, whole genome shotgun sequence.	GCF0004812451	NZKI5190121	88920	137012	48092
Pseudomonas aeruginosa strain AUS258 IPC249_2.1, whole genome shotgun sequence	GCF0039766751	NZRXFF010000021	475412	496368	20956
Pseudomonas aeruginosa strain PASGNDM586 PASGNDM586_contig_26, whole genome shotgun sequence.	GCF0021349151	NZNDFT010000361	55930	116115	60185
Pseudomonas aeruginosa strain PA34 NODE_2_length_1682555_cov_71.9527_ID_3, whole genome shotgun sequence.	GCF0025917651	NZPDLR010000061	301292	326226	24934
Pseudomonas aeruginosa strain X9820 contig1, whole genome shotgun sequence.	GCF0027240951	NZJPEA010000011	2395610	2411395	15785
Pseudomonas aeruginosa isolate 153, whole genome shotgun sequence.	GCF9001449651	NZFRJS010000771	7790	27591	19801
Pseudomonas aeruginosa strain S292_C06_RS S292_C06_RS_NODE_5_length_380787, whole genome shotgun sequence.	GCF0021361651	NZNFGM010000051	173507	187370	13863
Pseudomonas aeruginosa strain 326S290611BSL_PA2 IPC76_3.1, whole genome shotgun sequence	GCF0043741951	NZRWTR010000031	85584	97733	12149
Pseudomonas aeruginosa strain Pa359 K47_S99_R1__paired__contig_66, whole genome shotgun sequence	GCF0036698851	NZNRBZ010000661	43497	68967	25470
Pseudomonas aeruginosa strain SJU-W20_3 NODE_2_length_539633_cov_59.4503, whole genome shotgun sequence.	GCF0023297251	NZNRES010000021	41930	61641	19711
Pseudomonas aeruginosa DNA, complete genome, strain: 8380.	GCF0015481351	NZAP0148391	2595939	2622750	26811
Pseudomonas aeruginosa BWHPSA027 genomic scaffold adgfz-supercont1.1, whole genome shotgun sequence.	GCF0004811651	NZKI5189731	1651252	1671053	19801
Pseudomonas aeruginosa strain 6452 NODE_1_length_337230_cov_26.559491, whole genome shotgun sequence	GCF0079229151	NZVOJD010000011	223869	249518	25649
Pseudomonas aeruginosa 3573 adTvP-supercont1.6, whole genome shotgun sequence.	GCF0006293251	NZKK2130851	47730	61941	14211
Pseudomonas aeruginosa strain PA-W46 IPC1303_1.1, whole genome shotgun sequence	GCF0038335251	NZNSMW010000011	278467	304115	25648
Pseudomonas aeruginosa strain SF3, whole genome shotgun sequence	GCF0078603051	NZSZXP010000011	346578	372228	25650
Pseudomonas aeruginosa strain Pa1175 K11_S94_R1__paired__contig_26, whole genome shotgun sequence	GCF0036700551	NZNRBT010000261	17322	66769	49447
Pseudomonas aeruginosa strain TNCF_167 NODE_20_length_142594_cov_10.4092_ID_39, whole genome shotgun sequence.	GCF0017660751	NZMBMN010000221	83356	130507	47151
Pseudomonas aeruginosa str. MSH 10 contig025, whole genome shotgun sequence.	GCF0004124351	NZASQX010000251	44732	63100	18368
Pseudomonas aeruginosa strain 160 scaffold_1, whole genome shotgun sequence	GCF0043499551	NZSCWX010000021	104663	124373	19710
Pseudomonas aeruginosa strain AZPAE15014 AZPAE15014_contig_8, whole genome shotgun sequence.	GCF0007929451	NZJTOG010000081	244284	263983	19699
Pseudomonas aeruginosa strain AR_0355 AR0355.contig.0_1, whole genome shotgun sequence.	GCF0030006551	NZPSQQ010000011	4942151	4957109	14958
Pseudomonas aeruginosa isolate 207, whole genome shotgun sequence.	GCF9001454951	NZFRLZ010000031	4503	26131	21628
Pseudomonas aeruginosa strain Liverpool Epidemic Strain, whole genome shotgun sequence.	GCF0008243251	NZCCPB010000031	37741	121242	83501
Pseudomonas aeruginosa strain AES1R chromosome, complete genome	GCF0043551451	NZCP0379261	2436501	2449446	12945
Pseudomonas aeruginosa strain AUS210 IPC231_4.1, whole genome shotgun sequence	GCF0038399151	NZNSZG010000041	402854	429047	26193
Pseudomonas aeruginosa strain TNCF_42 NODE_15_length_179672_cov_30.6636_ID_29, whole genome shotgun sequence.	GCF0017656451	NZMAZM010000181	120401	167552	47151
Pseudomonas aeruginosa strain PAC44D IPC157_2.1, whole genome shotgun sequence	GCF0043732751	NZRWRW010000021	301485	355424	53939
Pseudomonas aeruginosa strain PA33 contig000012, whole genome shotgun sequence.	GCF0033327151	NZQDGP010000121	59461	119655	60194
Pseudomonas aeruginosa strain AUS464 IPC432_1.1, whole genome shotgun sequence	GCF0039757051	NZRXEE010000011	481977	497079	15102
Pseudomonas aeruginosa strain E1(T4189) IPC1138_1.1, whole genome shotgun sequence	GCF0038342351	NZNSPK010000011	134159	158518	24359
Pseudomonas aeruginosa DNA, complete genome, strain: NCGM 1984.	GCF0008292551	NZAP0146461	2585994	2615218	29224
Pseudomonas aeruginosa strain M74707 contig1, whole genome shotgun sequence.	GCF0029270951	NZJPFA010000011	2584923	2615594	30671
Pseudomonas aeruginosa strain W5Aug16 IPC830_17.1, whole genome shotgun sequence	GCF0038364451	NZNSTB010000171	42312	62376	20064
Pseudomonas aeruginosa strain 97 NODE_13_length_171936_cov_75.7284, whole genome shotgun sequence	GCF0024118651	NZNXHR010000131	48112	119634	71522
Pseudomonas aeruginosa isolate 110, whole genome shotgun sequence.	GCF9001445251	NZFRIG010000011	99097	135107	36010
Pseudomonas aeruginosa strain AZPAE14818 AZPAE14818_contig_3, whole genome shotgun sequence.	GCF0007951851	NZJTVQ010000031	108018	136469	28451
Pseudomonas aeruginosa strain AUS124 IPC368_3.1, whole genome shotgun sequence	GCF0038392151	NZNSXL010000031	479577	528962	49385
Pseudomonas aeruginosa isolate 293, whole genome shotgun sequence.	GCF9001462351	NZFROV010000101	7782	21470	13688
Pseudomonas aeruginosa strain W70322 contig3, whole genome shotgun sequence.	GCF0029272151	NZJPFF010000031	229963	244178	14215
Pseudomonas aeruginosa strain AZPAE14813 AZPAE14813_contig_8, whole genome shotgun sequence.	GCF0007950851	NZJTVV010000081	4642	56231	51589
Pseudomonas aeruginosa genome assembly 262_2_5Pc_4_contgs_500, contig NODE_16_length_149523_cov_27.7961_ID_31, whole genome shotgun sequence.	GCF0013750351	NZCUXP010000691	78411	98212	19801
Pseudomonas aeruginosa B136-33, complete genome.	GCF0003595051	NC0209121	2395638	2422451	26813
Pseudomonas aeruginosa strain NCTC10782, whole genome shotgun sequence.	GCF9004553551	NZUGUK010000021	832529	847746	15217
Pseudomonas aeruginosa strain 12 IPC1594_1.1, whole genome shotgun sequence	GCF0043708851	NZRWLJ010000011	347793	369385	21592
Pseudomonas aeruginosa isolate 195, whole genome shotgun sequence.	GCF9001453651	NZFRLP010000081	7399	75168	67769
Pseudomonas aeruginosa strain Pae28, whole genome shotgun sequence	GCF0040538551	NZSBJT010000031	297899	349493	51594
Pseudomonas aeruginosa strain AZPAE14538 AZPAE14538_contig_7, whole genome shotgun sequence.	GCF0007965051	NZJTXX010000071	387529	410236	22707
Pseudomonas aeruginosa strain HIAE_PA01 10c, whole genome shotgun sequence.	GCF0030712651	NZQBET010000101	131096	159547	28451
Pseudomonas aeruginosa strain 243931 chromosome, complete genome	GCF0075591251	NZCP0417721	4861518	4890742	29224
Pseudomonas aeruginosa S54485 genomic scaffold adgfS-supercont1.1, whole genome shotgun sequence.	GCF0004818251	NZKI5192561	231010	290520	59510
Pseudomonas aeruginosa strain AR_0108 scaffold00001, whole genome shotgun sequence.	GCF0018752151	NZMPBN010000011	3227923	3283212	55289
Pseudomonas aeruginosa strain 4084336477 IPC1522_1.1, whole genome shotgun sequence	GCF0043709751	NZRWLW010000011	208114	261121	53007
Pseudomonas aeruginosa strain FDAARGOS_505 chromosome, complete genome	GCF0038130051	NZCP0338321	3993301	3997201	3900
Pseudomonas aeruginosa strain PA-W5 IPC1283_21.1, whole genome shotgun sequence	GCF0038337651	NZNSNQ010000211	16913	44231	27318
Pseudomonas aeruginosa strain JYH9 IPC1220_1.1, whole genome shotgun sequence	GCF0039750051	NZRXBX010000011	404164	424874	20710
Pseudomonas aeruginosa isolate 196, whole genome shotgun sequence.	GCF9001453851	NZFRLO010001151	7775	23556	15781
Pseudomonas aeruginosa strain NFHH01, whole genome shotgun sequence.	GCF9001680951	NZFUYU010000041	521884	558361	36477
Pseudomonas aeruginosa strain Ocean-238 unitig_0, whole genome shotgun sequence.	GCF0022636851	NZNMRT010000021	575891	628620	52729
Pseudomonas aeruginosa strain PA83 chromosome, complete genome.	GCF0022153451	NZCP0172931	2474838	2525621	50783
Pseudomonas aeruginosa strain HUM-338 NODE_5_length_182836_cov_19.079_ID_9, whole genome shotgun sequence	GCF0036317751	NZRAAG010000621	77472	132786	55314
Pseudomonas aeruginosa strain YB01 chromosome, complete genome	GCF0098670551	NZCP0281321	2368907	2383173	14266
Pseudomonas aeruginosa isolate XDR-PA, whole genome shotgun sequence	GCF9007085651	NZCAADPV0100001601	13398	75145	61747
Pseudomonas aeruginosa strain B17932 chromosome, complete genome	GCF0039523251	NZCP0344361	3778188	3800344	22156
Pseudomonas aeruginosa strain AZPAE15030 AZPAE15030_contig_47, whole genome shotgun sequence.	GCF0007919851	NZJTNQ010000471	83522	140524	57002
Pseudomonas aeruginosa strain U1i NODE_2_length_435599_cov_27.661, whole genome shotgun sequence.	GCF0023260551	NZNQZH010000021	293263	313064	19801
Pseudomonas aeruginosa isolate 90, whole genome shotgun sequence.	GCF9001443051	NZFRHK010000721	7806	24633	16827
Pseudomonas aeruginosa strain SS1 IPC1376_2.1, whole genome shotgun sequence	GCF0039742551	NZRXBA010000021	638031	681630	43599
Pseudomonas aeruginosa strain AU14820 NODE_2_length_605010_cov_7.28361_ID_3, whole genome shotgun sequence.	GCF0015554151	NZLSAG010000221	271369	325304	53935
Pseudomonas aeruginosa strain 5994 IPC1317_1.1, whole genome shotgun sequence	GCF0043717551	NZRWOS010000011	478480	526572	48092
Pseudomonas sp. HMSC05H02 Scaffold360, whole genome shotgun sequence.	GCF0009528051	NZKQ0015851	41375	57700	16325
Pseudomonas aeruginosa isolate blood, whole genome shotgun sequence	GCF9010102451	NZCAAKMM0100000031	2361741	2385039	23298
Pseudomonas aeruginosa strain AF9A isolate AA2 IPC1259_4.1, whole genome shotgun sequence	GCF0036988251	NZMCMJ010000041	70955	95887	24932
Pseudomonas aeruginosa strain 707A scaffold_2, whole genome shotgun sequence.	GCF0023125751	NZMWXM010000031	79416	127242	47826
Pseudomonas aeruginosa isolate 191, whole genome shotgun sequence.	GCF9001453351	NZFRLH010000751	43794	76226	32432
Pseudomonas aeruginosa strain Liverpool Epidemic Strain, whole genome shotgun sequence.	GCF0008240851	NZCCOA010000031	38474	125586	87112
Pseudomonas aeruginosa strain Jp241 IPC755_1.1, whole genome shotgun sequence	GCF0039761751	NZRXDB010000011	416249	449414	33165
Pseudomonas aeruginosa strain Liverpool Epidemic Strain, whole genome shotgun sequence.	GCF0008241651	NZCCOO010000031	37741	121242	83501
Pseudomonas aeruginosa strain PA-W17 IPC10_3.1, whole genome shotgun sequence	GCF0038416351	NZNTAU010000031	51544	60771	9227
Pseudomonas aeruginosa U2504 genomic scaffold adgfx-supercont1.1, whole genome shotgun sequence.	GCF0004817851	NZKI5192401	2234908	2264132	29224
Pseudomonas aeruginosa strain 6099 IPC1348_1.1, whole genome shotgun sequence	GCF0043713451	NZRWNO010000011	298221	331386	33165
Pseudomonas aeruginosa strain AZPAE15026 AZPAE15026_contig_1, whole genome shotgun sequence.	GCF0007913651	NZJTNU010000011	248145	258622	10477
Pseudomonas aeruginosa strain Liverpool Epidemic Strain, whole genome shotgun sequence.	GCF0008241851	NZCCOP010000031	37886	123916	86030
Pseudomonas aeruginosa strain 268 chromosome, complete genome	GCF0036411251	NZCP0327611	2692255	2721479	29224
Pseudomonas aeruginosa strain WH-SGI-V-07419 WH-SGI-V-07419_contig1, whole genome shotgun sequence.	GCF0014514051	NZLLPG010000011	553774	612820	59046
Pseudomonas aeruginosa isolate 245, whole genome shotgun sequence.	GCF9001458051	NZFRND010000531	99991	121453	21462
Pseudomonas aeruginosa strain PAC44B IPC155_2.1, whole genome shotgun sequence	GCF0043787351	NZRWRY010000021	301488	355427	53939
Pseudomonas aeruginosa strain 506 scaffold_0, whole genome shotgun sequence.	GCF0023126151	NZMWXV010000011	589734	612867	23133
Pseudomonas aeruginosa strain 173 scaffold_21, whole genome shotgun sequence.	GCF0023120551	NZMWXG010000221	54455	92850	38395
Pseudomonas aeruginosa 3579 adTwG-supercont1.1, whole genome shotgun sequence.	GCF0006292051	NZKK2125481	476799	487279	10480
Pseudomonas aeruginosa strain NCTC13921, whole genome shotgun sequence.	GCF9004555351	NZUAUD010000151	151417	204168	52751
Pseudomonas aeruginosa strain AUS505 IPC445_3.1, whole genome shotgun sequence	GCF0039756651	NZRXEB010000031	287775	308853	21078
Pseudomonas aeruginosa strain 8491 NODE_2_length_717155_cov_70.6962, whole genome shotgun sequence.	GCF0029420251	NZPTLX010000021	307529	336309	28780
Pseudomonas aeruginosa strain 6822 isolate NH57388A IPC88_2.1, whole genome shotgun sequence	GCF0036983651	NZMCMT010000021	318569	346312	27743
Pseudomonas aeruginosa strain SJU-W20_2 NODE_2_length_539633_cov_68.2475, whole genome shotgun sequence.	GCF0022853751	NZNRET010000021	477546	491410	13864
Pseudomonas aeruginosa strain PA11803, complete genome.	GCF0017928751	NZCP0150031	2604253	2657006	52753
Pseudomonas aeruginosa strain AR_0351 AR0351.contig.3_1, whole genome shotgun sequence.	GCF0030007951	NZPSQP010000041	5311640	5333807	22167
Pseudomonas aeruginosa strain AUS153 IPC392_2.1, whole genome shotgun sequence	GCF0039765051	NZRXEO010000021	402928	426368	23440
Pseudomonas aeruginosa str. C 1334 contig024, whole genome shotgun sequence.	GCF0004122951	NZASQT010000241	59987	81060	21073
Pseudomonas aeruginosa strain S658_C13_RS S658_C13_RS_NODE_2_length_586752, whole genome shotgun sequence.	GCF0021358451	NZNFFT010000021	236985	256696	19711
Pseudomonas aeruginosa strain HUM-276 NODE_8_length_189739_cov_26.0432_ID_15, whole genome shotgun sequence	GCF0036301051	NZRADP010000041	131196	151542	20346
Pseudomonas aeruginosa strain Liverpool Epidemic Strain, whole genome shotgun sequence.	GCF0008243051	NZCCOY010000031	53470	127769	74299
Pseudomonas aeruginosa strain 1608 1608_NODE_3_length_336633_cov_100.09, whole genome shotgun sequence	GCF0038636051	NZRRBJ010000031	39316	49796	10480
Pseudomonas aeruginosa isolate 131, whole genome shotgun sequence.	GCF9001447351	NZFRJB010000021	103989	140650	36661
Pseudomonas aeruginosa strain env142 NODE_34_length_76817_cov_7.43123, whole genome shotgun sequence.	GCF0023302551	NZNRAN010000341	39340	65925	26585
Pseudomonas aeruginosa strain W5Aug28 IPC831_1.1, whole genome shotgun sequence	GCF0039752251	NZRXCQ010000011	477957	526049	48092
Pseudomonas aeruginosa strain SCVFeb, complete genome.	GCF0019001951	NZCP0134771	2408400	2430296	21896
Pseudomonas aeruginosa isolate 86, whole genome shotgun sequence.	GCF9001442651	NZFRHE010000271	103964	126638	22674
Pseudomonas aeruginosa isolate 285, whole genome shotgun sequence.	GCF9001461551	NZFROM010000371	7785	66830	59045
Pseudomonas aeruginosa strain 6007 6007_NODE_1.ctg_1, whole genome shotgun sequence.	GCF0021938451	NZNIOY010000321	315849	335560	19711
Pseudomonas aeruginosa strain 1622 1622_NODE_3_length_550640_cov_104.202, whole genome shotgun sequence	GCF0038635751	NZRRBN010000031	164732	175213	10481
Pseudomonas aeruginosa strain 4 IPC1586_2.1, whole genome shotgun sequence	GCF0043709851	NZRWLR010000021	291852	318044	26192
Pseudomonas aeruginosa strain PA37 contig000014, whole genome shotgun sequence.	GCF0033326651	NZQDGN010000141	43867	109908	66041
Pseudomonas aeruginosa strain AR_0357 chromosome, complete genome.	GCF0029689551	NZCP0271661	6227589	6262660	35071
Pseudomonas aeruginosa strain HUM-281 NODE_11_length_156773_cov_18.229_ID_21, whole genome shotgun sequence	GCF0036318651	NZQZZZ010001031	51409	106723	55314
Pseudomonas aeruginosa strain VD609 scaffold_0, whole genome shotgun sequence.	GCF0023127051	NZMWYN010000011	409408	449017	39609
Pseudomonas aeruginosa strain S422_C09_BS S422_C09_BS_NODE_4_length_348443, whole genome shotgun sequence.	GCF0021361351	NZNFGK010000041	113108	132820	19712
Pseudomonas aeruginosa strain 1650 1650_NODE_1_length_402965_cov_94.7816, whole genome shotgun sequence	GCF0038637451	NZRRBQ010000011	164581	186240	21659
Pseudomonas mendocina strain 1267_PMEN 1176_123565_1967346_417+,...,328+, whole genome shotgun sequence.	GCF0010625651	NZJVWH010003241	15245	69173	53928
Pseudomonas aeruginosa isolate 413.1, whole genome shotgun sequence.	GCF9001479651	NZFRVN010001701	41866	61577	19711
Pseudomonas aeruginosa BWH058 adTyf-supercont1.1, whole genome shotgun sequence.	GCF0006294251	NZKK2131831	2498793	2518594	19801
Pseudomonas aeruginosa strain AJ D 2 chromosome	GCF0047690551	NZCP0386611	3089712	3109247	19535
Pseudomonas aeruginosa strain AES1M chromosome, complete genome	GCF0043551251	NZCP0379251	3621912	3640708	18796
Pseudomonas aeruginosa strain IMP-13 chromosome, complete genome	GCF0039500151	NZCP0343541	5618052	5664930	46878
Pseudomonas aeruginosa strain S819_C17_BS S819_C17_BS_NODE_9_length_234266, whole genome shotgun sequence.	GCF0021356851	NZNFFH010000091	168742	181553	12811
Pseudomonas aeruginosa strain SJU-W4_3 NODE_10_length_229733_cov_57.511, whole genome shotgun sequence.	GCF0025164151	NZNREV010000101	42983	69176	26193
Pseudomonas aeruginosa strain BAMC 07-48, complete genome.	GCF0016322451	NZCP0153771	4731030	4749602	18572
Pseudomonas aeruginosa strain AZPAE14712 AZPAE14712_contig_57, whole genome shotgun sequence.	GCF0007972051	NZJTWU010000571	24931	85116	60185
Pseudomonas aeruginosa strain PAC112A IPC178_1.1, whole genome shotgun sequence	GCF0043730251	NZRWRC010000011	478009	526101	48092
Pseudomonas aeruginosa strain WH-SGI-V-07290 WH-SGI-V-07290_contig2, whole genome shotgun sequence.	GCF0014541251	NZLLUN010000121	42203	139745	97542
Pseudomonas aeruginosa strain AZPAE15016 AZPAE15016_contig_1, whole genome shotgun sequence.	GCF0007929651	NZJTOE010000011	246840	266641	19801
Pseudomonas aeruginosa strain PA-W29 IPC1291_3.1, whole genome shotgun sequence	GCF0038335851	NZNSNI010000031	85785	179140	93355
Pseudomonas aeruginosa strain PA_D1, complete genome.	GCF0017217451	NZCP0125851	2518245	2544572	26327
Pseudomonas aeruginosa strain Liverpool Epidemic Strain, whole genome shotgun sequence.	GCF0008242451	NZCCOU010000031	37741	121242	83501
Pseudomonas aeruginosa strain 110238627 IPC1509_6.1, whole genome shotgun sequence	GCF0043704051	NZRWMJ010000061	102736	107377	4641
Pseudomonas aeruginosa strain WH-SGI-V-07501 WH-SGI-V-07501_contig1, whole genome shotgun sequence.	GCF0014532251	NZLLQH010000011	477479	496926	19447
Pseudomonas aeruginosa isolate 171, whole genome shotgun sequence.	GCF9001451251	NZFRKN010000481	48327	73975	25648
Pseudomonas aeruginosa strain GIMC5002:PAT-169 chromosome	GCF0083700851	NZCP0435491	3683493	3718564	35071
Pseudomonas aeruginosa genome assembly 236_Rw196_contgs_500, contig NODE_18_length_149523_cov_33.4292_ID_35, whole genome shotgun sequence.	GCF0013736751	NZCTDE010000611	78411	98212	19801
Pseudomonas aeruginosa strain HIAE_PA06 4c, whole genome shotgun sequence.	GCF0030553851	NZQBEQ010000041	353915	374027	20112
Pseudomonas aeruginosa strain AMT0006-66 IPC547_2.1, whole genome shotgun sequence	GCF0038403651	NZNSVR010000021	477883	525978	48095
Pseudomonas aeruginosa isolate 440, whole genome shotgun sequence.	GCF9001476651	NZFRUI010000641	4502	24213	19711
Pseudomonas aeruginosa strain R3207 GCID_CRPK_0026_NODE_2.ctg_1, whole genome shotgun sequence	GCF0039549851	NZRWXB010001061	188534	214182	25648
Pseudomonas aeruginosa strain TNCF_154 NODE_23_length_98655_cov_9.22612_ID_45, whole genome shotgun sequence.	GCF0017659551	NZMBMJ010000281	39419	86569	47150
Pseudomonas aeruginosa strain M64 NODE_23_length_81349_cov_19.7393, whole genome shotgun sequence	GCF0041235651	NZSDVG010000231	38144	63434	25290
Pseudomonas aeruginosa strain AZPAE14815 AZPAE14815_contig_7, whole genome shotgun sequence.	GCF0007951151	NZJTVT010000071	113261	178169	64908
Pseudomonas aeruginosa strain 15 IPC1598_1.1, whole genome shotgun sequence	GCF0043700151	NZRWLF010000011	35223	48439	13216
Pseudomonas aeruginosa strain SCH_ABX06 ABX06_contig000003, whole genome shotgun sequence.	GCF0020012751	NZMVBS010000031	473475	491020	17545
Pseudomonas aeruginosa strain TNCF_13 NODE_7_length_259204_cov_14.2679_ID_13, whole genome shotgun sequence.	GCF0017657751	NZMAZI010000251	83298	130449	47151
Pseudomonas aeruginosa isolate 203.1, whole genome shotgun sequence.	GCF9001478451	NZFRUZ010000241	7786	15155	7369
Pseudomonas aeruginosa strain PB367 chromosome, complete genome.	GCF0028129251	NZCP0250561	2539921	2569145	29224
Pseudomonas aeruginosa strain PAC70A IPC165_1.1, whole genome shotgun sequence	GCF0043732351	NZRWRP010000011	421865	456371	34506
Pseudomonas aeruginosa strain PA-VAP-2 chromosome	GCF0043470251	NZCP0283311	3363764	3388996	25232
Pseudomonas aeruginosa isolate 156, whole genome shotgun sequence.	GCF9001449851	NZFRJM010000161	101805	127453	25648
Pseudomonas aeruginosa strain AMT0020-1 IPC550_1.1, whole genome shotgun sequence	GCF0038403451	NZNSVP010000011	444835	484433	39598
Pseudomonas aeruginosa strain KCRI-610 isolate RDK01_610, whole genome shotgun sequence.	GCF9004069651	NZOVDC010000011	113100	176497	63397
Pseudomonas aeruginosa strain R4393 GCID_CRPK_0017_NODE_4.ctg_1, whole genome shotgun sequence	GCF0039550751	NZRWWS010001481	24566	77344	52778
Pseudomonas aeruginosa isolate 203, whole genome shotgun sequence.	GCF9001454451	NZFRLT010001091	7774	15143	7369
Pseudomonas aeruginosa strain RIVM-EMC2982 chromosome, complete genome.	GCF0020856051	NZCP0169551	4427601	4505750	78149
Pseudomonas aeruginosa strain AMT0006-65 IPC546_2.1, whole genome shotgun sequence	GCF0039754351	NZRXDM010000021	478016	526111	48095
Pseudomonas aeruginosa isolate 208, whole genome shotgun sequence.	GCF9001455051	NZFRMA010000541	4503	26131	21628
Pseudomonas aeruginosa BWHPSA040 adkfQ-supercont1.1, whole genome shotgun sequence.	GCF0005203951	NZKI9145271	2396829	2427390	30561
Pseudomonas aeruginosa strain WH-SGI-V-07234 WH-SGI-V-07234_contig1, whole genome shotgun sequence.	GCF0014499651	NZLLNF010000011	263717	285991	22274
Pseudomonas aeruginosa strain S54485 IPC1180_14.1, whole genome shotgun sequence	GCF0038354951	NZNSOR010000141	44038	109395	65357
Pseudomonas aeruginosa strain AUS158 IPC397_1.1, whole genome shotgun sequence	GCF0039757351	NZRXEK010000011	515726	538690	22964
Pseudomonas aeruginosa strain WH-SGI-V-07312 WH_SGI_V_07312_6, whole genome shotgun sequence.	GCF0014543351	NZLLVB010000431	17403	36209	18806
Pseudomonas aeruginosa isolate 290, whole genome shotgun sequence.	GCF9001462051	NZFROU010000041	39289	98334	59045
Pseudomonas aeruginosa strain 9AR3 scaffold1.1, whole genome shotgun sequence.	GCF0017564251	NZLZQK010000011	473160	491650	18490
Pseudomonas aeruginosa BWH057 adTyM-supercont1.1, whole genome shotgun sequence.	GCF0006294451	NZKK2131881	1781350	1804467	23117
Pseudomonas aeruginosa strain AZPAE15036 AZPAE15036_contig_9, whole genome shotgun sequence.	GCF0007896451	NZJTNK010000091	145845	218265	72420
Pseudomonas aeruginosa isolate 210, whole genome shotgun sequence.	GCF9001455251	NZFRMC010000121	224675	246303	21628
Pseudomonas aeruginosa strain NCTC13359 genome assembly, chromosome: 1	GCF9014725451	NZLR5904731	2906501	2921954	15453
Pseudomonas aeruginosa strain AZPAE14972 AZPAE14972_contig_9, whole genome shotgun sequence.	GCF0007920251	NZJTPW010000091	33989	49770	15781
Pseudomonas aeruginosa BWH050 adTzs-supercont1.1, whole genome shotgun sequence.	GCF0006295851	NZKK2132721	1371148	1389722	18574
Pseudomonas aeruginosa strain WH-SGI-V-07705 WH-SGI-V-07705_contig9, whole genome shotgun sequence.	GCF0014537551	NZLLSZ010001201	146201	198979	52778
Pseudomonas aeruginosa strain AUS526 IPC450_1.1, whole genome shotgun sequence	GCF0039755751	NZRXDX010000011	1599507	1613628	14121
Pseudomonas aeruginosa strain PA8281, complete genome.	GCF0017928551	NZCP0150021	2469260	2522013	52753
Pseudomonas aeruginosa BL16 genomic scaffold adgeK-supercont1.1, whole genome shotgun sequence.	GCF0004808251	NZKI5188251	1550871	1570672	19801
Pseudomonas aeruginosa strain HIAE_PA21 1c, whole genome shotgun sequence.	GCF0030552951	NZQBEB010000011	476473	496275	19802
Pseudomonas aeruginosa LESlike7 sequence.	GCF0005839151	NZCP0069811	2461635	2508504	46869
Pseudomonas aeruginosa strain AUS217 IPC241_11.1, whole genome shotgun sequence	GCF0038398751	NZNSZD010000111	95404	156718	61314
Pseudomonas aeruginosa strain AR_0358 AR0358.contig.4_1, whole genome shotgun sequence.	GCF0030007551	NZPSQR010000051	4139680	4204573	64893
Pseudomonas aeruginosa strain KRP1 chromosome, complete genome	GCF0096768851	NZCP0460691	2423387	2470270	46883
Pseudomonas aeruginosa genome assembly 255_15_211Ga_contgs_500, contig NODE_17_length_149523_cov_25.3289_ID_33, whole genome shotgun sequence.	GCF0013739951	NZCUXO010000461	78411	98212	19801
Pseudomonas aeruginosa strain R4643 GCID_CRPK_0024_NODE_4.ctg_1, whole genome shotgun sequence	GCF0039554951	NZRWWZ010000061	24575	77353	52778
Pseudomonas aeruginosa strain SMC4386 contig_149, whole genome shotgun sequence.	GCF0014828851	NZLOQZ010001491	537280	571230	33950
Pseudomonas aeruginosa strain AZPAE15029 AZPAE15029_contig_21, whole genome shotgun sequence.	GCF0007921451	NZJTNR010000211	121889	176899	55010
Pseudomonas aeruginosa strain HUM-313-D1 NODE_7_length_237743_cov_28.3378_ID_13, whole genome shotgun sequence	GCF0036288651	NZRAFZ010000581	133621	189521	55900
Pseudomonas aeruginosa strain AR_0353 chromosome, complete genome.	GCF0029686551	NZCP0271721	4613377	4627643	14266
Pseudomonas aeruginosa strain PAC78A IPC148_1.1, whole genome shotgun sequence	GCF0043734051	NZRWSF010000011	816854	860462	43608
Pseudomonas aeruginosa strain MRSN12283 MRSN12283_contig00003, whole genome shotgun sequence	GCF0039698651	NZRXWK010000031	66729	75757	9028
Pseudomonas aeruginosa strain ATCC BAA-2114 IPC1582_2.1, whole genome shotgun sequence.	GCF0022370551	NZMVHB010000021	478158	497319	19161
Pseudomonas aeruginosa strain AZPAE14931 AZPAE14931_contig_10, whole genome shotgun sequence.	GCF0007937651	NZJTRK010000101	121046	150416	29370
Pseudomonas aeruginosa strain DUN-018 IPC1031_3.1, whole genome shotgun sequence	GCF0038351551	NZNSQV010000031	42262	118729	76467
Pseudomonas aeruginosa isolate 235, whole genome shotgun sequence.	GCF9001457251	NZFRMZ010000741	7784	23399	15615
Pseudomonas aeruginosa isolate PSA-14, whole genome shotgun sequence	GCF9001069151	NZFNMS010000231	346703	372352	25649
Pseudomonas aeruginosa BL15 genomic scaffold adgeO-supercont1.1, whole genome shotgun sequence.	GCF0004808451	NZKI5188351	1722237	1756452	34215
Pseudomonas aeruginosa strain 4124363505 IPC1474_1.1, whole genome shotgun sequence	GCF0043707351	NZRWNM010000011	691268	714585	23317
Pseudomonas aeruginosa strain HCF367 IPC1415_1.1, whole genome shotgun sequence	GCF0039745351	NZRXAG010000011	468866	497382	28516
Pseudomonas aeruginosa strain AZPAE14939 AZPAE14939_contig_25, whole genome shotgun sequence.	GCF0007935951	NZJTRC010000251	4635	18746	14111
Pseudomonas aeruginosa strain LIM1256 NODE_100_length_98027_cov_19.582615, whole genome shotgun sequence.	GCF0032044351	NZQJPD010000911	0	58381	58381
Pseudomonas aeruginosa strain PASGNDM592 PASGNDM592_contig_14, whole genome shotgun sequence.	GCF0021349051	NZNDFX010000251	55930	116115	60185
Pseudomonas aeruginosa strain AZPAE14904 AZPAE14904_contig_16, whole genome shotgun sequence.	GCF0007911551	NZJTSL010000161	269865	331612	61747
Pseudomonas aeruginosa strain PA-W28 IPC1290_4.1, whole genome shotgun sequence	GCF0038340251	NZNSNJ010000041	42262	185113	142851
Pseudomonas aeruginosa strain Pae81, whole genome shotgun sequence	GCF0040538651	NZSBKA010000011	352517	374152	21635
Pseudomonas aeruginosa strain 32SB IPC580_2.1, whole genome shotgun sequence	GCF0043728751	NZRWQQ010000021	185939	216726	30787
Pseudomonas aeruginosa strain delta6_3 chromosome	GCF0098000051	NZCP0470621	3079840	3099375	19535
Pseudomonas aeruginosa strain DUN-013 IPC1018_2.1, whole genome shotgun sequence	GCF0038351451	NZNSQY010000021	395954	411832	15878
Pseudomonas aeruginosa strain U0330A IPC940_1.1, whole genome shotgun sequence	GCF0038360251	NZNSRZ010000011	1406457	1435827	29370
Pseudomonas aeruginosa PAO1 isolate 2017-F CEC24_7, whole genome shotgun sequence	GCF0039570951	NZQZGB010000071	157799	171487	13688
Pseudomonas aeruginosa strain Lw1047 IPC879_2.1, whole genome shotgun sequence	GCF0038373051	NZNSSS010000021	384361	400238	15877
Pseudomonas aeruginosa strain 1811-13R031 chromosome, complete genome	GCF0096767651	NZCP0460611	2695327	2760164	64837
Pseudomonas aeruginosa strain R4164 GCID_CRPK_0015_NODE_7.ctg_1, whole genome shotgun sequence	GCF0039550151	NZRWWQ010000031	80097	99262	19165
Pseudomonas aeruginosa strain ATCC 9027 NODE_10_length_255721_cov_53.2964, whole genome shotgun sequence.	GCF0025633351	NZPDLX010000101	127543	183010	55467
Pseudomonas aeruginosa strain AU12424 NODE_1_length_811184_cov_9.54437_ID_1, whole genome shotgun sequence.	GCF0015548751	NZLRZN010000111	359692	419358	59666
Pseudomonas aeruginosa strain 6003 IPC1329_1.1, whole genome shotgun sequence	GCF0043715551	NZRWOG010000011	477768	525860	48092
Pseudomonas aeruginosa strain 178 scaffold_2, whole genome shotgun sequence	GCF0043497851	NZSCWI010000031	33895	47758	13863
Pseudomonas aeruginosa strain PASGNDM593 PASGNDM593_contig_18, whole genome shotgun sequence.	GCF0021349851	NZNDFY010000321	55930	116115	60185
Pseudomonas aeruginosa strain KCRI-462 isolate RDK06_462, whole genome shotgun sequence.	GCF9004069551	NZOVDB010000021	113108	138117	25009
Pseudomonas aeruginosa strain A237 IPC696_6.1, whole genome shotgun sequence	GCF0038369851	NZNSUR010000061	215243	234866	19623
Pseudomonas aeruginosa strain RD1-3 chromosome, complete genome	GCF0099117351	NZCP0476971	4450942	4478956	28014
Pseudomonas aeruginosa strain EGD-AQ8 Scaffold_22, whole genome shotgun sequence.	GCF0028969251	NZPPFS010000221	489217	515802	26585
Pseudomonas aeruginosa strain MSH10 IPC1179_1.1, whole genome shotgun sequence	GCF0039759151	NZRXBZ010000011	532867	551235	18368
Pseudomonas aeruginosa strain PABL070 NODE_15_length_101377_cov_70.1268, whole genome shotgun sequence	GCF0034112651	NZQVBZ010000151	39293	53157	13864
Pseudomonas aeruginosa strain AZPAE14395 AZPAE14395_contig_5, whole genome shotgun sequence.	GCF0007960651	NZJTYR010000051	303318	324947	21629
Pseudomonas aeruginosa genome assembly 249_2_5Pc_3_contgs_500, contig NODE_2_length_451161_cov_20.3236_ID_3, whole genome shotgun sequence.	GCF0013739351	NZCUXM010000251	78436	98237	19801
Pseudomonas aeruginosa strain AZPAE14403 AZPAE14403_contig_6, whole genome shotgun sequence.	GCF0007961251	NZJTYO010000061	236928	256638	19710
Pseudomonas aeruginosa isolate 291, whole genome shotgun sequence.	GCF9001462251	NZFROS010000561	98606	163498	64892
Pseudomonas aeruginosa strain env065a NODE_17_length_165089_cov_9.12665, whole genome shotgun sequence.	GCF0023304251	NZNRBG010000171	55419	114929	59510
Pseudomonas aeruginosa BWH056 adTwB-supercont1.1, whole genome shotgun sequence.	GCF0006294651	NZKK2132021	1699661	1722778	23117
Pseudomonas aeruginosa strain M8A4 genome.	GCF0021169851	NZCP0156481	3953325	3973300	19975
Pseudomonas aeruginosa isolate 159, whole genome shotgun sequence.	GCF9001450151	NZFRJT010001281	101777	127425	25648
Pseudomonas aeruginosa genome assembly 227_2_5Pc_9_contgs_500, contig NODE_1_length_793346_cov_18.4296_ID_1, whole genome shotgun sequence.	GCF0013747351	NZCUXF010000471	420621	440422	19801
Pseudomonas aeruginosa strain AUS512 IPC449_1.1, whole genome shotgun sequence	GCF0039756051	NZRXDY010000011	473415	486810	13395
Pseudomonas aeruginosa strain Ocean-1187 scaffold29_cov474_read217, whole genome shotgun sequence.	GCF0022635851	NZNMRQ010000291	54951	82682	27731
Pseudomonas aeruginosa strain CR1 chromosome, complete genome.	GCF0030253452	NZCP0205601	2374775	2389794	15019
Pseudomonas aeruginosa strain S2820 IPC905_1.1, whole genome shotgun sequence	GCF0038372251	NZNSSI010000011	300495	349724	49229
Pseudomonas aeruginosa strain AA44 IPC1276_3.1, whole genome shotgun sequence	GCF0038338451	NZNSNU010000031	84272	109204	24932
Pseudomonas aeruginosa strain CCF_839 contig_78, whole genome shotgun sequence.	GCF0019096151	NZMPUS010000781	87540	145379	57839
Pseudomonas aeruginosa isolate 212, whole genome shotgun sequence.	GCF9001455451	NZFRME010000411	4503	26131	21628
Pseudomonas aeruginosa strain NCTC13715 genome assembly, chromosome: 1	GCF9006369751	NZLR1343301	4365843	4421156	55313
Pseudomonas aeruginosa strain 1811-18R001 chromosome, complete genome	GCF0096767851	NZCP0460601	2695327	2760164	64837
Pseudomonas aeruginosa strain JB2 chromosome, complete genome.	GCF0030608451	NZCP0289171	4628112	4668398	40286
Pseudomonas aeruginosa strain AUS156 IPC395_2.1, whole genome shotgun sequence	GCF0039764951	NZRXEM010000021	88746	111537	22791
Pseudomonas aeruginosa strain ATCC 33352 scaffold_25, whole genome shotgun sequence.	GCF0014202651	NZLJNY010000261	35093	54628	19535
Pseudomonas aeruginosa strain TNCF_109 NODE_1_length_728222_cov_19.6429_ID_1, whole genome shotgun sequence.	GCF0017659151	NZMAZX010000201	247027	294177	47150
Pseudomonas aeruginosa strain PA-W31 IPC1292_1.1, whole genome shotgun sequence	GCF0038340151	NZNSNH010000011	214969	248134	33165
Pseudomonas aeruginosa strain 57SJ IPC584_2.1, whole genome shotgun sequence	GCF0043728451	NZRWQO010000021	743742	768682	24940
Pseudomonas aeruginosa strain AR441 chromosome, complete genome.	GCF0030736951	NZCP0290931	2520772	2532189	11417
Pseudomonas aeruginosa M8A.2 genomic scaffold adgfd-supercont1.1, whole genome shotgun sequence.	GCF0004805951	NZKI5187411	1617014	1631142	14128
Pseudomonas aeruginosa strain WH-SGI-V-07502 WH-SGI-V-07502_contig4, whole genome shotgun sequence.	GCF0014518651	NZLLQI010000341	536142	592042	55900
Pseudomonas aeruginosa strain PB353 chromosome, complete genome.	GCF0028128651	NZCP0250511	2463610	2514391	50781
Pseudomonas aeruginosa strain AZPAE15027 AZPAE15027_contig_42, whole genome shotgun sequence.	GCF0007912351	NZJTNT010000421	93957	122779	28822
Pseudomonas aeruginosa strain 2325 2325_NODE_1.ctg_1, whole genome shotgun sequence.	GCF0021936851	NZNIOO010000331	419801	476804	57003
Pseudomonas aeruginosa strain F9670, complete genome.	GCF0015428351	NZCP0088731	5777633	5787379	9746
Pseudomonas sp. HMSC070B12 Scaffold177, whole genome shotgun sequence.	GCF0018375451	NZKV8328781	527192	546639	19447
Pseudomonas aeruginosa strain AZPAE14811 AZPAE14811_contig_16, whole genome shotgun sequence.	GCF0007950451	NZJTVX010000161	17326	66773	49447
Pseudomonas aeruginosa isolate 126.1, whole genome shotgun sequence.	GCF9001477051	NZFRUN010000651	38226	69040	30814
Pseudomonas aeruginosa strain WH-SGI-V-07678 WH-SGI-V-07678_contig1, whole genome shotgun sequence.	GCF0014535451	NZLLRY010000011	43348	190721	147373
Pseudomonas aeruginosa PAK chromosome 1	GCF9021723051	NZLR6573041	2468770	2486334	17564
Pseudomonas aeruginosa strain PA-W39 IPC1298_11.1, whole genome shotgun sequence	GCF0038340051	NZNSNB010000111	152961	180279	27318
Pseudomonas aeruginosa strain VET-52 PA2_C3_NODE_4_length_91663_cov_19.2507_ID_7, whole genome shotgun sequence	GCF0036307051	NZRACL010001051	42251	75416	33165
Pseudomonas aeruginosa strain PS1 NODE_5_length_411470_cov_52.190929, whole genome shotgun sequence	GCF0037256351	NZRHDU010000051	304845	357205	52360
Pseudomonas aeruginosa strain PABL048 NODE_16_length_94055_cov_70.8601, whole genome shotgun sequence	GCF0034117851	NZQVCU010000161	73350	82598	9248
Pseudomonas aeruginosa RP73, complete genome.	GCF0004140351	NC0215771	3154254	3169420	15166
Pseudomonas aeruginosa strain AZPAE14867 AZPAE14867_contig_2, whole genome shotgun sequence.	GCF0007902151	NZJTTV010000021	55326	194145	138819
Pseudomonas aeruginosa isolate 163, whole genome shotgun sequence.	GCF9001450551	NZFRJZ010000551	7792	27593	19801
Pseudomonas aeruginosa LCT-PA220 Scaffold001, whole genome shotgun sequence.	GCF0004398551	NZKE5032121	843265	852994	9729
Pseudomonas aeruginosa strain CCUG 59626 contig_3, whole genome shotgun sequence	GCF0081809251	NZVTBE010000031	333804	361093	27289
Pseudomonas aeruginosa strain 146 scaffold_0, whole genome shotgun sequence	GCF0043505251	NZSCXJ010000011	183640	210958	27318
Pseudomonas aeruginosa BWHPSA016 genomic scaffold adgfN-supercont1.1, whole genome shotgun sequence.	GCF0004813851	NZKI5190681	2359126	2382458	23332
Pseudomonas aeruginosa strain PAC95A IPC182_2.1, whole genome shotgun sequence	GCF0043729851	NZRWQY010000021	555329	598937	43608
Pseudomonas aeruginosa isolate 88, whole genome shotgun sequence.	GCF9001443151	NZFRHM010000341	103509	126183	22674
Pseudomonas aeruginosa strain GO69 NODE_1_length_718389_cov_23.343618, whole genome shotgun sequence	GCF0090253951	NZWCHW010000011	519728	552385	32657
Pseudomonas aeruginosa strain AZPAE12413 AZPAE12413_contig_3, whole genome shotgun sequence.	GCF0007971251	NZJUAB010000031	119276	168709	49433
Pseudomonas aeruginosa 213BR 213BR chromosome, whole genome shotgun sequence, complete genome.	GCF0002239651	NZAFXK010000011	3354993	3413593	58600
Pseudomonas aeruginosa strain F429 isolate A5803 IPC1272_3.1, whole genome shotgun sequence	GCF0036986051	NZMCMA010000031	160157	175938	15781
Pseudomonas aeruginosa DSM 50071, complete genome.	GCF0010456851	NZCP0120011	2396954	2411227	14273
Pseudomonas aeruginosa strain M65 NODE_24_length_81349_cov_21.6334, whole genome shotgun sequence	GCF0041235451	NZSDVF010000241	38144	63434	25290
Pseudomonas aeruginosa E2 genomic scaffold adgft-supercont1.1, whole genome shotgun sequence.	GCF0004820051	NZKI5193051	1667043	1696131	29088
Pseudomonas aeruginosa strain PA102 contig000005, whole genome shotgun sequence.	GCF0033325851	NZQDGU010000051	166319	175347	9028
Pseudomonas aeruginosa strain AZPAE12155 AZPAE12155_contig_14, whole genome shotgun sequence.	GCF0007969551	NZJUAH010000141	113198	132909	19711
Pseudomonas aeruginosa genome assembly 235_Rw146_contgs_500, contig NODE_19_length_149523_cov_23.128_ID_37, whole genome shotgun sequence.	GCF0013736551	NZCTDD010000551	78411	98212	19801
Pseudomonas aeruginosa strain RM1 contig1, whole genome shotgun sequence.	GCF0029271951	NZJPFB010000011	2592494	2606358	13864
Pseudomonas aeruginosa strain AZPAE15042 chromosome, complete genome	GCF0069717851	NZCP0413541	2465646	2563586	97940
Pseudomonas aeruginosa strain Pa1242 chromosome, complete genome.	GCF0022053751	NZCP0220021	4645274	4812576	167302
Pseudomonas aeruginosa strain MUC-N1, whole genome shotgun sequence	GCF0088430651	NZWBZH010000261	34997	54532	19535
Pseudomonas aeruginosa isolate 325, whole genome shotgun sequence.	GCF9001465451	NZFRQA010000211	7797	66840	59043
Pseudomonas aeruginosa strain 21 IPC1604_1.1, whole genome shotgun sequence	GCF0043699351	NZRWKZ010000011	609166	624029	14863
Pseudomonas aeruginosa strain PAC97A IPC184_1.1, whole genome shotgun sequence	GCF0043729251	NZRWQW010000011	277055	305610	28555
Pseudomonas aeruginosa strain MRSN12280 chromosome, complete genome.	GCF0030283351	NZCP0281621	2613731	3304556	690825
Pseudomonas aeruginosa strain PA-W19 IPC12_2.1, whole genome shotgun sequence	GCF0038411851	NZNTAS010000021	384234	403945	19711
Pseudomonas aeruginosa E2 IPC1165_2.1, whole genome shotgun sequence	GCF0038344551	NZNSOW010000021	475357	504445	29088
Pseudomonas aeruginosa strain AU9017 NODE_1_length_811195_cov_5.85313_ID_1, whole genome shotgun sequence.	GCF0015548251	NZLRZJ010000111	359699	419368	59669
Pseudomonas aeruginosa strain 55AA isolate PAK IPC83_3.1, whole genome shotgun sequence	GCF0036983851	NZMCMY010000031	546741	564305	17564
Pseudomonas aeruginosa strain PAC11A IPC127_1.1, whole genome shotgun sequence	GCF0043739351	NZRWSY010000011	1473980	1489595	15615
Pseudomonas aeruginosa strain M28A1 genome.	GCF0021170251	NZCP0156491	5758274	5790116	31842
Pseudomonas aeruginosa strain AZPAE12418 AZPAE12418_contig_32, whole genome shotgun sequence.	GCF0007972451	NZJTZW010000321	117499	137776	20277
Pseudomonas aeruginosa strain PA-CL511 IPC605_2.1, whole genome shotgun sequence	GCF0043724151	NZRWQC010000021	712759	716880	4121
Pseudomonas aeruginosa strain HIAE_PA08 1c, whole genome shotgun sequence.	GCF0030553251	NZQBEO010000011	693881	697786	3905
Pseudomonas aeruginosa 19BR 19BR chromosome, whole genome shotgun sequence, complete genome.	GCF0002239451	NZAFXJ010000011	3341689	3400289	58600
Pseudomonas aeruginosa strain AU2342 NODE_13_length_221296_cov_6.87048_ID_25, whole genome shotgun sequence.	GCF0015544651	NZLRYI010000041	41928	61639	19711
Pseudomonas aeruginosa strain HIAE_PA09 2c, whole genome shotgun sequence.	GCF0030552651	NZQBEN010000021	120427	177430	57003
Pseudomonas aeruginosa isolate PcyII-10 genome assembly, chromosome: PcyII-10.	GCF9001492851	NZLT6736561	2387765	2402628	14863
Pseudomonas aeruginosa strain AMT0026-3 IPC555_1.1, whole genome shotgun sequence	GCF0038385251	NZNSVO010000011	347052	372700	25648
Pseudomonas aeruginosa strain env187 NODE_2_length_531767_cov_18.066, whole genome shotgun sequence.	GCF0023319851	NZNRGD010000021	120116	139917	19801
Pseudomonas aeruginosa genome assembly 269_Tsb_Bead_Pool_2_contgs_500, contig NODE_3_length_373318_cov_25.7979_ID_5, whole genome shotgun sequence.	GCF0013751751	NZCUXT010000171	78411	98212	19801
Pseudomonas aeruginosa strain 6D92(H) isolate AMT0023-30 IPC1260_2.1, whole genome shotgun sequence	GCF0036984551	NZMCMI010000021	42124	96075	53951
Pseudomonas aeruginosa strain WH-SGI-V-07249 WH-SGI-V-07249_contig13, whole genome shotgun sequence.	GCF0014528351	NZLLTJ010000051	103694	162739	59045
Pseudomonas aeruginosa genome assembly 296_Rw204_contgs_500, contig NODE_17_length_133642_cov_30.251_ID_33, whole genome shotgun sequence.	GCF0013743951	NZCTFO010000381	19059	38073	19014
Pseudomonas aeruginosa strain 333S200112BSL_PA1 IPC78_2.1, whole genome shotgun sequence	GCF0043741851	NZRWTP010000021	328422	340571	12149
Pseudomonas aeruginosa strain AZPAE15037 AZPAE15037_contig_24, whole genome shotgun sequence.	GCF0007899351	NZJTNJ010000241	110362	169408	59046
Pseudomonas aeruginosa strain AR_0064 scaffold00007, whole genome shotgun sequence.	GCF0018751851	NZMPBU010000071	462963	521561	58598
Pseudomonas aeruginosa strain AMT0005-136 IPC541_2.1, whole genome shotgun sequence	GCF0039755051	NZRXDP010000021	495337	509201	13864
Pseudomonas aeruginosa YL84, complete genome.	GCF0005245951	NZCP0071471	4799723	4809969	10246
Pseudomonas aeruginosa BWHPSA008 genomic scaffold adgga-supercont1.2, whole genome shotgun sequence.	GCF0004815451	NZKI5191351	2403586	2423327	19741
Pseudomonas aeruginosa strain COPD6d Contig2, whole genome shotgun sequence	GCF0020216351	NZMWLC010000021	7799	205048	197249
Pseudomonas aeruginosa C20 genomic scaffold adgfy-supercont1.1, whole genome shotgun sequence.	GCF0004805151	NZKI5187191	2544969	2593061	48092
Pseudomonas aeruginosa strain MRSN443463 MRSN443463_contig00061, whole genome shotgun sequence	GCF0039683251	NZRXTU010000611	24504	51317	26813
Pseudomonas aeruginosa strain NCTC13628, whole genome shotgun sequence	GCF9007069851	NZCAADJR0100000021	1432518	1493837	61319
Pseudomonas aeruginosa strain MCF182 IPC1369_1.1, whole genome shotgun sequence	GCF0039747951	NZRXBE010000011	738336	748657	10321
Pseudomonas aeruginosa isolate paerg010 genome assembly, chromosome: 0	GCF9006183151	NZLR1305361	2371927	2410950	39023
Pseudomonas aeruginosa isolate PSA-10, whole genome shotgun sequence	GCF9001061551	NZFNLR010000271	315968	348625	32657
Pseudomonas aeruginosa BWHPSA037 adkgb-supercont1.3, whole genome shotgun sequence.	GCF0005204551	NZKI9145741	710745	728670	17925
Pseudomonas aeruginosa PAO1 isolate 2017-B CEC22_16, whole genome shotgun sequence	GCF0039571851	NZQZFX010000161	39315	53003	13688
Pseudomonas aeruginosa strain AMT0047-125 IPC564_13.1, whole genome shotgun sequence	GCF0039762251	NZRXDG010000131	305582	325293	19711
Pseudomonas aeruginosa UCBPP-PA14 chromosome, complete genome.	GCF0000146251	NC0084631	2474141	2493942	19801
Pseudomonas aeruginosa BWHPSA020 genomic scaffold adgeC-supercont1.2, whole genome shotgun sequence.	GCF0004813051	NZKI5190381	294827	315900	21073
Pseudomonas aeruginosa strain Cas9_2 chromosome	GCF0098001251	NZCP0470681	3079855	3099390	19535
Pseudomonas aeruginosa strain WH-SGI-V-07073 WH-SGI-V-07073_contig1, whole genome shotgun sequence.	GCF0014492551	NZLLLG010000011	468659	479139	10480
Pseudomonas aeruginosa strain TNCF_155 NODE_12_length_179633_cov_27.4724_ID_23, whole genome shotgun sequence.	GCF0017659751	NZMBMK010000131	120385	167537	47152
Pseudomonas aeruginosa strain AZPAE14890 AZPAE14890_contig_37, whole genome shotgun sequence.	GCF0007908251	NZJTSY010000371	129997	149667	19670
Pseudomonas aeruginosa strain 2032935751 IPC1498_2.1, whole genome shotgun sequence	GCF0043711551	NZRWMU010000021	432829	471655	38826
Pseudomonas aeruginosa strain PA-W42 IPC1299_1.1, whole genome shotgun sequence	GCF0038339551	NZNSNA010000011	215069	248234	33165
Pseudomonas aeruginosa BWH059 adTvw-supercont1.1, whole genome shotgun sequence.	GCF0006294051	NZKK2131731	1756593	1783911	27318
Pseudomonas aeruginosa BL19 genomic scaffold adgeJ-supercont1.1, whole genome shotgun sequence.	GCF0004807651	NZKI5188141	1692892	1717808	24916
Pseudomonas aeruginosa strain WH-SGI-V-07495 WH-SGI-V-07495_contig10, whole genome shotgun sequence.	GCF0014517551	NZLLQB010000021	112527	171572	59045
Pseudomonas aeruginosa isolate paerg005 genome assembly, chromosome: 0	GCF9006182851	NZLR1305341	2649791	2659017	9226
Pseudomonas aeruginosa strain 13 IPC1595_2.1, whole genome shotgun sequence	GCF0043700751	NZRWLI010000021	195216	220864	25648
Pseudomonas aeruginosa strain JYH24 IPC1235_1.1, whole genome shotgun sequence	GCF0038344051	NZNSOE010000011	485618	505329	19711
Pseudomonas aeruginosa strain 85 NODE_6_length_253448_cov_53.3418, whole genome shotgun sequence.	GCF0024119151	NZNXHS010000061	152804	213964	61160
Pseudomonas aeruginosa strain 6436 NODE_2_length_349212_cov_19.905521, whole genome shotgun sequence	GCF0079229251	NZVOJE010000021	164580	184382	19802
Pseudomonas aeruginosa strain A9 IPC688_3.1, whole genome shotgun sequence	GCF0038376451	NZNSUZ010000031	120953	139245	18292
Pseudomonas aeruginosa strain NCTC11449, whole genome shotgun sequence.	GCF9004552051	NZUGUG010000061	697285	722933	25648
Pseudomonas aeruginosa strain TNCF_10M NODE_22_length_93122_cov_10.7154_ID_43, whole genome shotgun sequence.	GCF0017654551	NZMAUT010000401	33899	81050	47151
Pseudomonas aeruginosa NCMG1179 DNA, contig: scaffold00001, whole genome shotgun sequence.	GCF0002917451	NZDF1265931	3593622	3636597	42975
Pseudomonas aeruginosa strain VET-58 PA2_E4_NODE_2_length_194407_cov_13.4378_ID_3, whole genome shotgun sequence	GCF0036335151	NZQZXD010001171	17443	64398	46955
Pseudomonas aeruginosa genome assembly 225_Tsb_2_contgs_500, contig NODE_2_length_451136_cov_22.2705_ID_3, whole genome shotgun sequence.	GCF0013746951	NZCTCX010000331	78411	98212	19801
Pseudomonas aeruginosa genome assembly 225_Tsb_2_contgs_500, contig NODE_7_length_256525_cov_23.7798_ID_13, whole genome shotgun sequence.	GCF0013746951	NZCTCX010000311	192397	209130	16733
Pseudomonas aeruginosa strain PA_D22, complete genome.	GCF0017218251	NZCP0125831	2518245	2544572	26327
Pseudomonas aeruginosa strain VET-46 PA4_A2_NODE_8_length_227199_cov_43.263_ID_15, whole genome shotgun sequence	GCF0036296551	NZRAEM010000161	94712	177023	82311
Pseudomonas aeruginosa strain Liverpool Epidemic Strain, whole genome shotgun sequence.	GCF0008242851	NZCCOW010000031	37741	121242	83501
Pseudomonas aeruginosa isolate 279, whole genome shotgun sequence.	GCF9001460951	NZFROH010000371	35790	100682	64892
Pseudomonas aeruginosa strain Zw49 IPC1383_5.1, whole genome shotgun sequence	GCF0039746251	NZRXAW010000051	518654	530913	12259
Pseudomonas aeruginosa strain SJU-W4_2 NODE_1_length_624374_cov_42.898, whole genome shotgun sequence.	GCF0023300751	NZNREW010000011	42983	69176	26193
Pseudomonas aeruginosa isolate 329, whole genome shotgun sequence.	GCF9001466051	NZFRQE010000091	99091	163981	64890
Pseudomonas aeruginosa isolate 204, whole genome shotgun sequence.	GCF9001454651	NZFRLW010000061	7777	15146	7369
Pseudomonas aeruginosa isolate 129, whole genome shotgun sequence.	GCF9001447051	NZFRIY010001101	153937	184751	30814
Pseudomonas aeruginosa strain C79 chromosome, complete genome	GCF0078338951	NZCP0406841	2193277	2228092	34815
Pseudomonas aeruginosa strain Zw70 IPC1399_2.1, whole genome shotgun sequence	GCF0039741351	NZRXAP010000021	188202	248526	60324
Pseudomonas aeruginosa strain env158 NODE_4_length_422598_cov_12.589, whole genome shotgun sequence.	GCF0023265051	NZNRAJ010000041	129864	164370	34506
Pseudomonas aeruginosa strain env045 NODE_3_length_437281_cov_14.3629, whole genome shotgun sequence.	GCF0023304751	NZNRBJ010000031	289883	311542	21659
Pseudomonas aeruginosa strain AZPAE14722 AZPAE14722_contig_30, whole genome shotgun sequence.	GCF0007966451	NZJTWK010000301	39286	53149	13863
Pseudomonas aeruginosa strain 5991 IPC1314_3.1, whole genome shotgun sequence	GCF0043718251	NZRWOV010000031	22224	50974	28750
Pseudomonas aeruginosa strain HUM-229 NODE_25_length_103391_cov_28.0213_ID_49, whole genome shotgun sequence	GCF0036325251	NZQZXW010001191	26554	53139	26585
Pseudomonas aeruginosa strain PA_154197, complete genome.	GCF0020750651	NZCP0148661	2435179	2461883	26704
Pseudomonas aeruginosa strain PA77 PA77_HGAP3_2SMC_c1, whole genome shotgun sequence.	GCF0022115451	NZMJMC010000011	391089	398053	6964
Pseudomonas aeruginosa strain HUM-295 PA3_B8_NODE_3_length_303537_cov_39.2247_ID_5, whole genome shotgun sequence	GCF0036294751	NZRAEU010000391	120391	177394	57003
Pseudomonas aeruginosa strain env225 NODE_2_length_775444_cov_23.2835, whole genome shotgun sequence.	GCF0023266251	NZNRAB010000021	272433	297445	25012
Pseudomonas aeruginosa strain Zw75_2 IPC1438_1.1, whole genome shotgun sequence	GCF0039743951	NZRWZS010000011	680012	710835	30823
Pseudomonas aeruginosa isolate 214, whole genome shotgun sequence.	GCF9001455651	NZFRMG010000471	35050	48266	13216
Pseudomonas aeruginosa strain H47921, complete genome.	GCF0015163451	NZCP0088611	1208569	1229242	20673
Pseudomonas aeruginosa 3578 adTxa-supercont1.7, whole genome shotgun sequence.	GCF0006292251	NZKK2126511	80976	91456	10480
Pseudomonas aeruginosa strain 1510 1510_NODE_3_length_527976_cov_110.832, whole genome shotgun sequence	GCF0038638251	NZRRBG010000031	172686	222244	49558
Pseudomonas aeruginosa strain SJU-W4_1 NODE_2_length_624374_cov_55.5829, whole genome shotgun sequence.	GCF0023300951	NZNREX010000021	42983	69176	26193
Pseudomonas aeruginosa strain AZPAE14373 AZPAE14373_contig_2, whole genome shotgun sequence.	GCF0007958751	NZJTYX010000021	476137	535301	59164
Pseudomonas aeruginosa strain PA121617, complete genome.	GCF0016796851	NZCP0162141	5632170	5646034	13864
Pseudomonas aeruginosa strain JYH28 IPC1239_2.1, whole genome shotgun sequence	GCF0038338051	NZNSOC010000021	354074	373231	19157
Pseudomonas aeruginosa strain AR_0094 scaffold00003, whole genome shotgun sequence.	GCF0018752051	NZMPBR010000031	849279	859026	9747
Pseudomonas aeruginosa strain BK5 contig_8, whole genome shotgun sequence.	GCF0022429151	NZLFDG010000081	132905	149568	16663
Pseudomonas aeruginosa strain AUS465 IPC227_7.1, whole genome shotgun sequence	GCF0038398451	NZNSZI010000071	122500	138828	16328
Pseudomonas aeruginosa genome assembly 272_Rw200_contgs_500, contig NODE_19_length_149523_cov_24.3041_ID_37, whole genome shotgun sequence.	GCF0013752351	NZCTFD010000401	78411	98212	19801
Pseudomonas aeruginosa strain HUM-257 PA3_C4_NODE_2_length_368020_cov_37.7123_ID_3, whole genome shotgun sequence	GCF0036314351	NZRABB010000691	215180	229974	14794
Pseudomonas aeruginosa strain 5990.2 IPC1312_1.1, whole genome shotgun sequence	GCF0043718551	NZRWOX010000011	297878	318430	20552
Pseudomonas aeruginosa strain HUM-319-D1 PA3_E10_NODE_6_length_183300_cov_25.9577_ID_11, whole genome shotgun sequence	GCF0036315951	NZRAAS010000761	77494	132826	55332
Pseudomonas aeruginosa strain PA-W35 IPC20_1.1, whole genome shotgun sequence	GCF0038415751	NZNTAK010000011	1241584	1257199	15615
Pseudomonas aeruginosa strain PAC5B IPC113_2.1, whole genome shotgun sequence	GCF0043745851	NZRWTM010000021	500872	522598	21726
Pseudomonas aeruginosa strain CF16053 contig_8, whole genome shotgun sequence	GCF0082445751	NZVTFM010000081	301342	322970	21628
Pseudomonas aeruginosa PAO1 isolate 2017-E CEC18_16, whole genome shotgun sequence	GCF0039570751	NZQZGA010000161	35074	54609	19535
Pseudomonas aeruginosa M8A.3 genomic scaffold adger-supercont1.2, whole genome shotgun sequence.	GCF0004805751	NZKI5187381	2380635	2394763	14128
Pseudomonas aeruginosa strain AZPAE14851 AZPAE14851_contig_20, whole genome shotgun sequence.	GCF0007898351	NZJTUK010000201	122674	149992	27318
Pseudomonas aeruginosa strain AZPAE13866 AZPAE13866_contig_44, whole genome shotgun sequence.	GCF0007955851	NZJTZH010000441	35026	48242	13216
Pseudomonas aeruginosa strain NCTC6750, whole genome shotgun sequence.	GCF9004616351	NZUGUL010000021	4627540	4643416	15876
Pseudomonas aeruginosa strain 6093 IPC1341_2.1, whole genome shotgun sequence	GCF0043713251	NZRWNU010000021	136486	158812	22326
Pseudomonas aeruginosa BWHPSA001 genomic scaffold adges-supercont1.1, whole genome shotgun sequence.	GCF0004816851	NZKI5191841	2436647	2466008	29361
Pseudomonas aeruginosa strain 519119 chromosome, complete genome	GCF0075591051	NZCP0417731	4979140	5134440	155300
Pseudomonas aeruginosa strain 105857 LT19_contig000001, whole genome shotgun sequence.	GCF0016016651	NZLOHJ010000011	52734	93248	40514
